# # # # # # # # # # # #
# . # . . . . . . . . #
# . . . . . . . . . . #
# . # . . . . . . . . #
# . . x # . . # . . . #
# . . . . . . . . . . #
# . . x . . # . . . . #
# . . . x . . . . . . #
# . . . . . # # . . . #
# . . # . . . . . # . #
# . . . . . . . . . . #
# # # # # # # # # # # #
