# # # # # # # # # # # #
# . . . . . . . x . . #
# . . . # . . . . . . #
# . . . . . . . . . # #
# . . # . # . . . . . #
# . . # # . . . . . . #
# . # . . . . . . x . #
# . . . # . . . . . . #
# . . . . . . . . . . #
# . . . # . . . # . . #
# x . . . . . . . . . #
# # # # # # # # # # # #
