# # # # # # # # #
# . . . . . . . #
# . . . . . . . #
# . . # . . . . #
# . . . . # . . #
# . . . . . # . #
# . . . . . . . #
# # . . . . . . #
# # # # # # # # #
