# # # # # # # # # # # #
# . . . . # . . . . . #
# . . # . . . . . # # #
# # . . . . . . . . . #
# . . # x . . . # . . #
# . . . . . x # . . . #
# . . . . . . # . . . #
# . . . . . . . . . . #
# . . . . . . . . . . #
# . . . . . . . # . . #
# . . . . . # . . . . #
# # # # # # # # # # # #
