# # # # # # # # # # # #
# . . # . . . . . x . #
# . . . . . . . . . . #
# . . . # . . . . # . #
# # # # . . x . . . . #
# . . . # x . # . . . #
# # # . . # . . # . . #
# . . # . . # # # . . #
# # . . . . . . . . . #
# . . . . . . . # . . #
# . . . . x . . . . . #
# # # # # # # # # # # #
