# # # # # # # # # # # #
# . . . . . . . # . . #
# x . . # . . . . # . #
# . . . x . . . . . . #
# . . . # # . . . x . #
# . . . . . # . . # . #
# . . . . x . . . . . #
# # . . # # . . # . . #
# . . . . # . . . # . #
# . . . # . # . # . . #
# . # . . # . . . # . #
# # # # # # # # # # # #
