# # # # # # # # # # # #
# . . . . . # # . . x #
# # # . . # . . # . x #
# # . . . . . . . . . #
# # . . # . . . . . . #
# . . . # # . . . . . #
# . . . . # # # # . . #
# . . x # x # . # . . #
# # . # . . . . . # . #
# . . . # # . . # . . #
# # . . # . # . . # . #
# # # # # # # # # # # #
