# # # # # # # # # # # #
# . . . . . . . . . # #
# . . . # # . . . . . #
# . . . . . . . . . # #
# x x . . . . # x . . #
# # . . . . # . . # # #
# # . . . . . . . . . #
# . . . . . . # . . . #
# . . # # . # x . . # #
# . . . . . . . . . . #
# . . . . . . . . . . #
# # # # # # # # # # # #
