# # # # # # # # # # # #
# . . . . # # . . . . #
# . # # . # . . . . . #
# . x . # # . . # . . #
# . . . . . . # . . . #
# . . . # . . # . # # #
# # . . # . . . . . . #
# . . . . . . . # . . #
# . x . . . . . . # . #
# # . . . . . . # . . #
# . . . . . . . . . . #
# # # # # # # # # # # #
