# # # # # # # # # # # #
# . # . . . . . . # . #
# . . . . x # # . . . #
# # . # . . . # . . . #
# x # . . . x . . . . #
# . . . . . . . . . # #
# # # . . . . # . . . #
# . . . . . . . . # . #
# . . # . . # . . . . #
# . x . . . . . . . . #
# . . . . . . . # # . #
# # # # # # # # # # # #
