# # # # # # # # # # # #
# . . . . # . . . . . #
# . . # . . . . . . . #
# . . # . . x . . . . #
# . . . . . . . # . . #
# . . . . . . # . . # #
# . . . # . . . . . . #
# . . x . . . . # . . #
# . . . . . . . # . . #
# . # # . . . . . . . #
# . . . . . . . . . . #
# # # # # # # # # # # #
