# # # # # # # # # # # # # # #
# . . . . . # . . # . # . . #
# . # . . # # . . . . . . . #
# . # # . # . # # # . # . . #
# . # . . # # . # # . . . . #
# . . . . . # . # # # # . # #
# . . . # . . # . . . . . # #
# . # # . # . # . . # . . . #
# . . . . # # . . # # . . . #
# # . # # . . . . . . . . . #
# . . . . . . . # . # # # . #
# . . . # . # # . . # # . . #
# # . # # . . # . . # . . # #
# . . . . . . # . . . # . . #
# # # # # # # # # # # # # # #
