# # # # # # # # # # # # # # #
# . . . . . . . . . . . . . #
# . . . . . . . . . . . . . #
# . . . . # . . . . . . . . #
# . . . . . . . . . . # . . #
# . . . . . . . . . . . . . #
# . . . # . . . . . . . . . #
# . . . . # . . . . . . . . #
# . . . . . . . . . . . . # #
# . . . . . . . . . . . . . #
# . . . . . . . . . . . . . #
# . . # . # . . . . . # . . #
# # . . . . . . . . # . . . #
# . . . . . . . . . # . . . #
# # # # # # # # # # # # # # #
