# # # # # # # # # # # #
# . . . # # . . . . . #
# . . . . . # . . . . #
# . # . . # # # . . x #
# . . . . . . . . . . #
# # . x . . . . . . # #
# . . # . . . . . . . #
# . . . . . . . . . . #
# . . . . . # . x . . #
# . . . . . . . . . . #
# # # . . . . . # . . #
# # # # # # # # # # # #
