# # # # # # # # # # # #
# . . . # . . . . # . #
# . . # . . . . . # . #
# . . . . . # . # . . #
# . . . # . . # . . . #
# . . . . . # . . . # #
# . # . . . . # . . . #
# . # # # . # x . . . #
# . . # # . . . . . . #
# # . . # . # . . . . #
# . . . # . . . x . . #
# # # # # # # # # # # #
