# # # # # # # # # # # #
# . . . . . x . . . . #
# # # . . . x . . . . #
# # . . . . . . . . . #
# . # x . . . . . x . #
# . . . . . . . . . . #
# . . . . # . . . . . #
# . . . . # . . . . . #
# . # . . . . . # # . #
# . . . . . . . . . . #
# . . . . . . . . # . #
# # # # # # # # # # # #
