# # # # # # # # # # # #
# . . # . . . # . . x #
# . . . . # . . # . . #
# . # . . . . # . . . #
# . . . . . . . . . . #
# . . . # . . # . . . #
# . . . . # . . # . . #
# . . . . . . # # # # #
# x . . . . . . . . . #
# . . . . . . . . . . #
# . . . . . . . . . . #
# # # # # # # # # # # #
