# # # # # # # # # # # #
# . . . . # # . . . . #
# . . . . . . . . . . #
# # . . . x . . . # . #
# . . . . . # . . . # #
# . x . . # . . . . . #
# . . . . . . # . . . #
# . . . . . . . . . . #
# . . # # . . . . . # #
# . . . . . . . . . . #
# . # . . . . . # . . #
# # # # # # # # # # # #
