# # # # # # # # # # # #
# . x # . . . . # . . #
# . . . x # . . . . . #
# . . . . . . # . . x #
# . . . . # . . . . # #
# . . . . . . . . . . #
# . . . . # . . . . . #
# # . . . . # # . . . #
# . . . . . # . # # . #
# . . . . . . . . . # #
# . . . . # # # x . . #
# # # # # # # # # # # #
