# # # # # # # # # # # #
# . # . . . . . . . . #
# . . . . . . # # . . #
# # x . # . . # x # . #
# # . . # . . . . . # #
# # . . . . . . . # # #
# . . . # . . . . . . #
# # x . . # . . . . . #
# . . # . . . . x . # #
# # . . . . . . . . . #
# . # . . # # . . . . #
# # # # # # # # # # # #
