# # # # # # # # # # # #
# . # . . . . # # . . #
# . . . . . . . # . . #
# . . . . # . . . . # #
# . # . . . . . . . . #
# # . # . . . . . . . #
# . . . . . . . . x . #
# . . . x # . . . . # #
# # . . # . # . . # . #
# . . . . # . . . . # #
# . x . . . . . . . . #
# # # # # # # # # # # #
