# # # # # # # # # # # #
# . . . . x # . . . . #
# . . # . . . . . # . #
# . # . . . . . . . . #
# . . . . . . . # . . #
# . . . . . . . . . . #
# . . . # . . # # . . #
# . . x . . # # . . . #
# . . . . . . . # . . #
# . . . . . . . . # . #
# . x . . . . . . . . #
# # # # # # # # # # # #
