# # # # # # # # # # # #
# . . . . . . . # . . #
# # . . . . # . . . x #
# . . . # . # . . . . #
# . . . . . # . # # . #
# # . . . . . # . . . #
# # . . . . . # . # . #
# . . . . . . . . . . #
# # x . . . . . . . # #
# # . . . # . . . . . #
# . . . . . . . . . . #
# # # # # # # # # # # #
