# # # # # # # # # # # #
# . . . . . . . . . . #
# . . . . . . . . . . #
# . . # . . # . . . . #
# . # . . . . . . . . #
# . x . . . . . . # . #
# . . . . . . . x . # #
# . . # . . . . . . # #
# . # . . # . . . x . #
# x . . . . . . . . . #
# . . . # # . . . . . #
# # # # # # # # # # # #
