# # # # # # # # # # # #
# . # . . . . # # # # #
# . . x # . . . # . . #
# . . . # . . x . . x #
# . . # . . . . . . # #
# . . . . . . . . . # #
# . # . . # . . . # x #
# . # . . # . # . . . #
# # # . . # . . # . . #
# . . . . # . . . . . #
# # # . # # . . # . . #
# # # # # # # # # # # #
