# # # # # # # # # # # #
# . . . . . . x # . x #
# . . . . . . . # . . #
# . . . . # . . # . x #
# # . . . . . # . . # #
# . . # . . . # . # . #
# . . . . . . # . . . #
# . . . . . # . . . . #
# . . # . . . . . . . #
# . # . . . . # . # # #
# . # . # . . . . . . #
# # # # # # # # # # # #
