# # # # # # # # #
# . . . . . . . #
# . . # . . # . #
# . . . # . # # #
# # . # . . . . #
# . . . # # . . #
# . # . # . . . #
# # . # # . . . #
# # # # # # # # #
