# # # # # # # # # # # #
# . . . . . x . . . . #
# . . . . x . . . . . #
# . . . . . . . . # . #
# . # . . . # . . . . #
# . # . # . . . . . . #
# . . . . . # . . . x #
# . . . . . . . # . x #
# . . # . . . . # . . #
# . . . . . . . . . . #
# . . . # . . . . . . #
# # # # # # # # # # # #
