# # # # # # # # # # # #
# . . . . # . # . . . #
# . . . . # . # # . # #
# . . . . # . . # . . #
# . . . . . . # . . . #
# . # # . . . . . . . #
# x . . . . . . . # . #
# . . . # . . . # . # #
# x . . . . . . . x . #
# . # . . . . . . . . #
# . # . # . . . # # . #
# # # # # # # # # # # #
