# # # # # # # # # # # # # # #
# . . . # . # . . . . . . # #
# . . . . . . . . . . # . . #
# # # # # # . . # . . # . . #
# . # . . # # . . # # # . . #
# . . . # . . . . . # # . . #
# . . . . # # . . . # # . . #
# # # . # . . . . . . . . # #
# # # . . # . . . # . . . . #
# # . # . . . . . # . # . . #
# . . . . # # # . . # # . . #
# . # # . . . # . # . # . . #
# . . . . # . . # . # . . . #
# . # . . # # . . # . . . . #
# # # # # # # # # # # # # # #
