# # # # # # # # # # # #
# . # . # . . . . . . #
# . # . . . x . . . . #
# . . . # # . x . . . #
# . . # . # # . . . . #
# . . # . . # . # . . #
# . . . . # . . # . . #
# # . . . . . . . . . #
# . # # # . . . # . . #
# . . # . x . . . # . #
# . # # . . # . . . . #
# # # # # # # # # # # #
