# # # # # # # # # # # #
# . . . . . . # . . # #
# . . . . x . . # . . #
# . . # . # . . . . # #
# . . # . . # # . . . #
# . . . . . . . # . . #
# x . . . . . . # . . #
# . . . . . . . . . . #
# # # # . . . . . . . #
# . x . . . # . . # . #
# . . # . . # . # . . #
# # # # # # # # # # # #
