# # # # # # # # # # # #
# . . . . . . . # . . #
# . . . . . x # # x . #
# x . # # # . . . . # #
# # . . # # . . . . . #
# . # . . . . . . # . #
# . # # . . . # . # # #
# . # # # # # . . # # #
# # . . . . # . . . . #
# . # # # # # . . . . #
# . . . . . . . . . . #
# # # # # # # # # # # #
