# # # # # # # # # # # #
# . . . # . # . . # # #
# . . . . . . . . . . #
# . . . . . . . . . . #
# # . . . . . . . . . #
# . # x . . . . # . . #
# . . . . . . . . . . #
# # . . . . . . . . # #
# # . . . . x . . . # #
# . . . . # . . . . . #
# . . . . # . . . . . #
# # # # # # # # # # # #
