# # # # # # # # # # # #
# . . . . . . x . . . #
# # . . . . . . . . . #
# . . . . . . . # . . #
# x # # . . . . . . . #
# . . . . . . . # . x #
# . . . . . . # . . . #
# . . . . . # . . . . #
# . . . . . # . . . . #
# . . . . # . . x . . #
# . . . # . . . . . . #
# # # # # # # # # # # #
