# # # # # # # # # # # #
# . . . . . # . . . . #
# . # . . # . . . . . #
# . . . . . . . . # x #
# . . # . . # . # . # #
# . x x . # . . . . . #
# # . . # # . . . . . #
# . . . . . x . . . . #
# # . . . . . . . # # #
# . . # . . . . . . . #
# . # . . # . # # . . #
# # # # # # # # # # # #
