# # # # # # # # # # # #
# . . . # . . . . . . #
# # . . . # . . . . # #
# . . . . . . . . . . #
# x # . . x . . . . . #
# . . . . . . . . . # #
# . . # . x . # # . # #
# . . . . . . . . . . #
# . . . . . . . . . . #
# . . . . # . . . . . #
# . . . . . . # . # . #
# # # # # # # # # # # #
