# # # # # # # # # # # #
# . . # . . . x . . . #
# . . . . . . # . . . #
# . . . . . # # . . . #
# . . . . # . . . . . #
# . . . . . # . . . . #
# . . # . . # # . . # #
# # . . . x . . x . # #
# . . . . . . . . # # #
# # . . # # # . . . . #
# . . . # # # . . . . #
# # # # # # # # # # # #
