# # # # # # # # # # # # # # #
# . . . # # . . . . # . # . #
# . . # . # . . . . . . # # #
# . . # # . . . . . # # . # #
# . . . # . . # . . . . . # #
# . . . . . . . . . # # . . #
# # . . # # . # . # . # . . #
# . . . # # . . . . # . . . #
# # . . . . . . . # . . # # #
# . . . . . . . # . # . . # #
# . . # # . . # . . . # # # #
# . . . . # . # # . . # . # #
# . . . # . . . . . . # . # #
# . # # # . . . . # . . . . #
# # # # # # # # # # # # # # #
