# # # # # # # # # # # #
# . . . # . . . . . . #
# . . . # . . . . # . #
# . . . # . . . . # . #
# . . . . . . . . . # #
# # . . . # x . . . . #
# . . . . . . . . # . #
# . . # . . . . . . . #
# . . . . . # # . . . #
# . . . x . . . . x . #
# . . . . . . . # . . #
# # # # # # # # # # # #
