# # # # # # # # # # # #
# . . . . # . . . . . #
# x . . . . . . # # . #
# . . . . . # . . . . #
# . . # . . . . . . x #
# . . . # . . . . x x #
# # # . # . . . . . . #
# # . # # . . . . . . #
# . . . . . . . . . . #
# . . . . . . . . . # #
# . . # . . . # # . . #
# # # # # # # # # # # #
