# # # # # # # # # # # #
# . . # . # . . . # . #
# # . . . . . . # # . #
# # . . . . . . . # # #
# . . . # . # # . # # #
# . . . . # . . . . . #
# . . . . . . . . . # #
# x . . # . # . . . . #
# # . # . . # . . . . #
# . . . # . . # . . . #
# . . . . x . # . . . #
# # # # # # # # # # # #
