# # # # # # # # # # # #
# . . # . . . . . . . #
# # . . . . . # # # # #
# . . # # . . . . # . #
# . # . . . . . # # . #
# . . . # . . # # x . #
# . . x . . . . . . . #
# # . # . . # . # . . #
# . . # x . . # . . # #
# . # . . # # # . . . #
# . # # # . # . # . . #
# # # # # # # # # # # #
