# # # # # # # # # # # #
# . . # . # . . # # . #
# # . . . . # . . # # #
# . # # . . # # # # x #
# # # # . # x # # . # #
# . # . . . . # . . # #
# x # # # # . . . # . #
# . . # . . . # . . . #
# . # # # . # # . . . #
# . # . . . . . # . . #
# # # . . . # . . # . #
# # # # # # # # # # # #
