# # # # # # # # # # # #
# . # . . . . . # # # #
# . . . . . . # . # # #
# # # . . # . # # . # #
# . . . . # . . # . x #
# . . # . . # . x . # #
# # # . . . . . . . . #
# # . . # # # . . # . #
# . . . . . . . . . . #
# . . . . . . # . . # #
# . . . . # . . . . . #
# # # # # # # # # # # #
