# # # # # # # # #
# . . . . # . . #
# . . . # . . . #
# . . . . # . . #
# . # . # . . . #
# . . . . . . # #
# . . . . . # . #
# . . # # . . . #
# # # # # # # # #
