# # # # # # # # # # # # # # #
# . . . . # . . # . . . . . #
# . . . . . # . # # . # # . #
# . . . . . . . . . . # . . #
# . # . # . # . # . # . # . #
# . # . # . . # . . . # . # #
# . # . # # . . . . . . # . #
# . . . . . # . . . . . . . #
# . # . . # . # . . . . . . #
# . . . # . . # . . . . # . #
# . . . . # . . . . . # . . #
# # # . . . . . # # . # . . #
# . # . . . . . . . . . . . #
# . . # . . . # . # . . . . #
# # # # # # # # # # # # # # #
