# # # # # # # # # # # #
# . . . . # . . . . # #
# . . # . # . . . . . #
# . . . . . . . . . # #
# . . # . . . . . # # #
# # . . . . . . . . . #
# . . . . . . . . . . #
# . . . . . # # . . . #
# . . . . . . . . x . #
# # . . . . . x . . . #
# . . . . . # . . . . #
# # # # # # # # # # # #
