# # # # # # # # # # # #
# . . . . # . . # # . #
# . . . # . . . . . # #
# # . . . . . . . . # #
# . . . . . . . . # . #
# . . # . # . . . . . #
# . . . . . # . . . . #
# . . . . x . . . # # #
# . . . # . . . . . . #
# . . . . . x . # . . #
# . . # . . . . . . . #
# # # # # # # # # # # #
