# # # # # # # # # # # # # # #
# . . . . . . . . . . . . . #
# . . . # . . . . # . . . . #
# # . . # # . . . . . . # . #
# . . . . # . . . . . . . # #
# # . . . . # # . # . . . . #
# . . . . . # # . . . . . . #
# . . # . # . . . . . . # # #
# . . . . . . . . . . . . . #
# . . . # # . . . . . . . . #
# . . . . . . . . . . . . . #
# . # # . . . # . . . . . . #
# . . . # . # . . . . # . . #
# . . . . . . # . . . . . . #
# # # # # # # # # # # # # # #
