# # # # # # # # # # # #
# . . . . # . # . . . #
# # . . . . . . . # . #
# . . . . . # . . . . #
# . # . . . . x . . # #
# . . . . . . . # . . #
# . . . . . . . . . . #
# . x . # . # . . . . #
# . . . . . . . . . . #
# . . . . . . . . # . #
# . . . . . . # . . . #
# # # # # # # # # # # #
