# # # # # # # # #
# . . . . # . . #
# . # . . . . . #
# . . . . . . . #
# . # . # . . . #
# . . . # . . . #
# . . . . . . . #
# . . # . . . . #
# # # # # # # # #
