# # # # # # # # # # # #
# . . . . . . . . # . #
# . # # . . . . . . . #
# . . . . . . # . . . #
# . x . . . . . . . . #
# . . . . . # x . # . #
# . . . # . . . . . . #
# . # . # . . . . . . #
# . . . . . . # . . . #
# . . . . . # . . . # #
# . . . . . . . . . . #
# # # # # # # # # # # #
