# # # # # # # # # # # #
# . . . . # # . . . . #
# . . . # . . . . . . #
# . . . . . . . . . . #
# . . . . # # . . . . #
# . # . . . . . . . # #
# . . . . . x . . . . #
# . . . # . . . # . # #
# # . . . . . . . . . #
# . . # . . . . . # . #
# . . . . . x . . . . #
# # # # # # # # # # # #
