# # # # # # # # # # # #
# . . . . # # . # . . #
# . . . . . . # . # . #
# . . . . # . . # . # #
# . # . x # . . . # . #
# . . . . . . . . . x #
# . . # . . . . . . . #
# . # . . . . . # . . #
# . . # # x . . # . # #
# . . . . . . . . . . #
# . . . . . . . # . . #
# # # # # # # # # # # #
