# # # # # # # # # # # #
# . . . x . . # . . # #
# . . . . . # . # . . #
# . . . . . # . . . . #
# . # . . # . . . . . #
# . . . # # . . . . . #
# . . . . . # . . . . #
# . . . . . # . # . . #
# # . . . . . . x . # #
# . # . . . # # . . x #
# # . . . . . . . . . #
# # # # # # # # # # # #
