# # # # # # # # #
# . # # . . # # #
# . # # . . . . #
# . . . . . . . #
# # . . . . . . #
# # . . . . . . #
# . . . . . # . #
# . . . . . . . #
# # # # # # # # #
