# # # # # # # # # # # #
# . . . . . . . . . . #
# . . . # . . # . . . #
# . . . . . # . . # . #
# . . # x . . . . . . #
# . # . . . # . . . . #
# # x # . . . . . . . #
# . . . . # # . . . . #
# . . . . x . . # . . #
# . . . . . # . . . . #
# . . . . . . . # . . #
# # # # # # # # # # # #
