# # # # # # # # # # # #
# . . # . . . # . . # #
# . . . . . # . # . . #
# . . . . # . . . . . #
# x . . . . x . . . . #
# # . . . . # . . . . #
# . . # # # . # . . . #
# . . . # . . . . . # #
# # . . . . . . . . . #
# # . # . # . . . # . #
# . . x . . # # . # . #
# # # # # # # # # # # #
