# # # # # # # # # # # #
# . . . . x # . . . . #
# . . . . . . . . . . #
# # . . . # . . x . . #
# # . . . . . x . . # #
# . # x . # . . # . # #
# . . . . . . . . # . #
# . . . . . . # . . . #
# . . # . . . . . . # #
# . . . . . # . . . . #
# . . . . # # . . # . #
# # # # # # # # # # # #
