# # # # # # # # # # # #
# . . . . . . # . # . #
# # x . x . . . # x # #
# . . # # # . . # # . #
# . . . # . . . . . # #
# . . . . # . # . . # #
# . . # # . . . . # . #
# # # # . # . . # . . #
# . . . . # . . . . # #
# . # . # . . . . . # #
# # . . # # # . . . . #
# # # # # # # # # # # #
