# # # # # # # # # # # #
# . . . . . . . . # . #
# . . . . # . . . . . #
# . . . . . # . . . . #
# . x # . . . . . . . #
# . . . . . . . . . . #
# . . . x . . . . # . #
# . . . . . . # . . . #
# . # . # . . # . . . #
# . x # . . . . . . . #
# . . . . . . . . . . #
# # # # # # # # # # # #
