# # # # # # # # # # # #
# . . . # . # . . . . #
# # . . # . # # . . . #
# . # . # . . . . . . #
# # . . . # . . x . . #
# x . . . . # . . . . #
# . . # . . . . . . # #
# . . . . . . . . # . #
# . # . . . x . . . . #
# . . . . . . . . . # #
# . . . . . . . # . . #
# # # # # # # # # # # #
