# # # # # # # # # # # #
# . . . . . # . # . . #
# . . # . . . # . # . #
# # . # # . . # # # . #
# . . # # . . . . # . #
# # . # . . # . . . # #
# . # # . . . x . . . #
# . . . # # x . # . . #
# # . . . . # # . # . #
# # . . . . . . . . . #
# . . . . . . . . . . #
# # # # # # # # # # # #
