# # # # # # # # # # # # # # #
# . . # . . . # . . . . . . #
# # . # . . . . . . . # . # #
# . . . . . . # . . . . # . #
# . . . . . . # . . . . # . #
# . . # . # . # . . . . . . #
# . . . . . # . # . . . . . #
# . . # . # . # . . . . . . #
# # . # . . # # # . . . . . #
# . . . . . . # . . # . . . #
# . # # . . . # . . . # . . #
# . . . . . . . . . # . . . #
# . . . # # . . . # # . # . #
# # . . . . . . . . . # . . #
# # # # # # # # # # # # # # #
