# # # # # # # # # # # #
# . x . . . . # . # . #
# . . . . # . . # . . #
# . . . . # # # . . # #
# . # # . # . . . . . #
# . . . . . . . . . . #
# . # # # . x . . x . #
# . . # . . # . . . . #
# . . . . . . . . . . #
# # . . . . . . x # . #
# . # . # . . . # . . #
# # # # # # # # # # # #
