# # # # # # # # # # # #
# . . . . . . . . . . #
# . . . . # . . . # # #
# . . . x . . . . . . #
# . # . . . . . . # . #
# . # . . . . . . # x #
# # . . # # . . . . # #
# . . . . . . . # # . #
# . . . . . . . . # . #
# . . . . . . . # . . #
# . # # . # # . . . . #
# # # # # # # # # # # #
