# # # # # # # # # # # #
# . . . . . # . . . . #
# . . . . . # . # x . #
# . # . . . . . . . . #
# x # # # . . # # x . #
# . . . # # . . . . # #
# . # . # . . . # . # #
# . . . . # . . # . . #
# # . . . . . # # . # #
# . . . . . . . # . . #
# # # . . # x . . # . #
# # # # # # # # # # # #
