# # # # # # # # # # # #
# . # . . # # . . . . #
# . . . . . . # # # . #
# . # . . . # . . . . #
# . . x . . # . # # . #
# . . # # . . . . . # #
# . . . # . . . . . . #
# # . . . x . . . . . #
# # . . . . # . . . . #
# # . . # . . . . # . #
# x . # x . . . # . . #
# # # # # # # # # # # #
