# # # # # # # # # # # #
# . # . . . . . # . . #
# . . . . # # . . . . #
# . . # # . . . . # . #
# . . # # . . . # # . #
# x . . . . # . . . . #
# . . x . . . # . . . #
# . . . . . . . . . . #
# . . . x . # # # # . #
# . # # . . . . . # . #
# . . . . . . . . . . #
# # # # # # # # # # # #
