# # # # # # # # # # # #
# . # . x . . # . . # #
# . . . . . . . . . . #
# . . . . . # . . . . #
# . . . . . . . . . . #
# . . . . # . . . . . #
# . . . . . . . . . . #
# . . . . . . . . . . #
# . # . . . . # # . . #
# . . . . . x # . . . #
# # . . . . . . . . . #
# # # # # # # # # # # #
