# # # # # # # # # # # #
# . . . . . . . # . . #
# . . . # . . . . . . #
# . . . . . . . . . . #
# . . . # . . . . . . #
# . . . x # x . . . . #
# . # . . # . # . . . #
# . . . . # . . # . . #
# . . # . . . . . # . #
# . x . . . # . . . # #
# . . . . . # . # . . #
# # # # # # # # # # # #
