# # # # # # # # # # # # # # #
# . . . . . . . # . . . . . #
# # . . . . . # # . . . . . #
# . . # . # . # . . # # . . #
# . . # . . . # . # . # . . #
# # # # . . # # . . . . . . #
# . . . . . . . . # . . # . #
# . . . . . # . . . . # # . #
# # . . # . . . . . . . . . #
# . # # # . . . . . . # # # #
# # . . . # . . . . . . # . #
# . . # . x . . # . . # . # #
# . . x . . # . . . # . . . #
# # . . # . . . . . . . # . #
# # # # # # # # # # # # # # #
