# # # # # # # # # # # #
# . . . . . . . . . . #
# . . . . . # # . . . #
# . . . # . # # . . . #
# . . . . . . . x . . #
# . . . . . x . . # . #
# . # . . . . . . . . #
# . . . . . . # . . . #
# . . . . # . . . . . #
# . . . . . . # . # . #
# . . . . . . . . . . #
# # # # # # # # # # # #
