# # # # # # # # # # # #
# . . . . . . . . . . #
# . . # # . . . . # . #
# . # . # . . . . . . #
# . . . # . # . # . . #
# . # . . . . . . x # #
# . . . . . . . . . # #
# . . . . . . . . . . #
# . # . . . . . # . . #
# . # . . . . . # . . #
# # . . . . x . . # . #
# # # # # # # # # # # #
