# # # # # # # # # # # #
# . . # . # . . . . # #
# . . . . . # . . # # #
# . . # . # # . . . x #
# . . . . . # . . . . #
# . . x . . . . . . . #
# . x . . . . . . . . #
# . # . . . . . . . . #
# . . . . . . . # . . #
# . . . . . . . . # # #
# . . . . . . . . . . #
# # # # # # # # # # # #
