# # # # # # # # # # # #
# . . # x # . # . . . #
# . . . . . . . . # . #
# . . # . . . . # # # #
# . . . . . # . . . . #
# . . . # # # # . . # #
# . # . # . x . . . # #
# . # . . . . . # # x #
# # . . # . # . # # . #
# # # . . # . . . . . #
# . # . . . # . . . . #
# # # # # # # # # # # #
