# # # # # # # # # # # #
# . . . . . . . . # # #
# . . . # . . . . . . #
# # . . # . . . . . . #
# . . . . . . . . . . #
# . . . . . . . . . . #
# x . . # . . . . . . #
# . x . # . . . . . # #
# . . . # . # . # . . #
# . . . . . . # . . x #
# . . . . . . . . . . #
# # # # # # # # # # # #
