# # # # # # # # # # # #
# . . . . # . . . . . #
# . # # . . # . # . . #
# . . . . . . . . . . #
# . . . # . . . # . # #
# . # . . . . . . . . #
# . x . x . . . . . # #
# # . # . . . . . . . #
# . . . . . # . . . . #
# # . . . . # # . # . #
# . x . . . # . . . . #
# # # # # # # # # # # #
