# # # # # # # # # # # #
# . . . . # . # . # . #
# . . # . . # # # . . #
# . # . # . . . . # # #
# . . . . # . # . . . #
# x . . # . . . . . . #
# . . . . . . . # # . #
# # . . . . . . . # . #
# . . . # # . . . . . #
# x . . . . . . . . . #
# x . . # # . # . . . #
# # # # # # # # # # # #
