# # # # # # # # # # # #
# . . . . . # . . . . #
# . . . . . . # . . . #
# # . x # . . . . . . #
# . . . . # . . # . . #
# . . . . . . # . . . #
# . . . . . . . . . x #
# . . # . # # . . . . #
# . . . . . . . . . . #
# . . . . . . . . . . #
# . x . . . . . . . . #
# # # # # # # # # # # #
