# # # # # # # # # # # #
# . . . . . x . . . . #
# . . . . . . . . . . #
# . . . . . # # . . . #
# # . . . # . # . # # #
# . . # . . . . . . . #
# . . . . . . . x . . #
# . . # . . . . . . # #
# . . . . . . # . . . #
# . # . # . . . . # . #
# . . . # . . . # . . #
# # # # # # # # # # # #
