# # # # # # # # # # # #
# . . . . . . # . # . #
# . . . . . . . . . . #
# . . . # . . . . # . #
# . . . # # # . . # . #
# # . . . . . # # . . #
# . . x . . x . . . . #
# . . # . . # . . . # #
# . # . . # . . . . . #
# . . . . . . . . . x #
# # . . . . # . # . . #
# # # # # # # # # # # #
