# # # # # # # # # # # #
# . . . . . . . . . . #
# . . # . . . . . . # #
# . # . . . . . . . # #
# . . . # . . . . # # #
# . . . . . . # . . . #
# . . . # . . . . . x #
# x . . . . . . . . . #
# . . . . . . . # . . #
# . . # . . . . . . . #
# . . # # . . . . . . #
# # # # # # # # # # # #
