# # # # # # # # # # # #
# . . # . x # . # . . #
# . # . . . . # # . . #
# . . . . . . . . . . #
# . . # . . . . . . . #
# . . # . . . . . . . #
# . . . . . . . x . . #
# . . . . . . . . . . #
# . . . . # . . # . . #
# . . . . . . . . . # #
# # . . # . . . . . . #
# # # # # # # # # # # #
