# # # # # # # # # # # #
# . . . . . . # . . . #
# . # . . # . . . . . #
# . . . . . . . . . . #
# # . . . . . # . . . #
# . . . . . . x # # . #
# # . . # . x # . . . #
# . x # . # . . . x . #
# . # # . # # . . . . #
# . . . # . . . # . . #
# . # . . . . . . . . #
# # # # # # # # # # # #
