# # # # # # # # # # # #
# . . . . . . . . . . #
# . . # . . # . # x . #
# . . . . . . # . . . #
# . . . . . . . . . . #
# . . . . . . . . . . #
# # . . . . x . . . . #
# . # . . . . . . . . #
# # . x . . # . . . . #
# . . . . . . . . . . #
# . . . . . # . . . . #
# # # # # # # # # # # #
