# # # # # # # # # # # #
# . # . # . . . . . # #
# . . . . . . . . . . #
# . . # x . # . . . . #
# . . . # . . . . . . #
# # . . # . # . . . . #
# . . . . . # . . . # #
# . . . . . . . . . . #
# . . . . . # # . . # #
# . # . . . x # . . # #
# . . . . # . . . . . #
# # # # # # # # # # # #
