# # # # # # # # # # # #
# . # . . . # . . . . #
# . . . . x . x # . . #
# . # # . . . . . . . #
# . # . # . . . . . . #
# # # . . . . . # . . #
# # . . . . . # . # # #
# # x . . . # . . . . #
# # . . . . # # . . . #
# . # x . . . . . . . #
# . . . . # . . # . . #
# # # # # # # # # # # #
