# # # # # # # # # # # #
# . # . . . . . . . . #
# . . . . . . . . x . #
# . . . . . . . . # . #
# . # . # # . . . . . #
# . . . . . . # . . . #
# . . . . . . . . . . #
# . . . . . x . . . # #
# . . . . # . . . . . #
# . . . . . # # . # . #
# # . . # . # . . . . #
# # # # # # # # # # # #
