# # # # # # # # # # # #
# . . . . . . . . . . #
# . . . . . . . . x . #
# . # . . . . # . . . #
# . . . . . # . . . . #
# # . . . . # # x . # #
# . # . . . . . . . # #
# . . . . . . . . . . #
# . . . . . # . . . # #
# . # . . . # # # . x #
# . . . . . # . . . . #
# # # # # # # # # # # #
