# # # # # # # # # # # #
# . . . . # . . # . . #
# . . x . . . . . . . #
# . . . # . . . . . . #
# . . . . . # . . . . #
# . . . . . . . . . . #
# x . . . . . # . . . #
# . . . . # # . . . . #
# . . . . . . . . x . #
# . . . . # . . . . . #
# . . . # . x . . # . #
# # # # # # # # # # # #
