# # # # # # # # # # # #
# . . . # . . . . . . #
# # . . . . . . # . # #
# . . # . . . . . . # #
# . . # x . . . . . x #
# . . # . . # . . . . #
# # . . . . . # x # . #
# . . # # . . . . # . #
# . . . . . . . . # . #
# # . . # # . . . . . #
# . . . . . . . . . . #
# # # # # # # # # # # #
