# # # # # # # # # # # #
# . . # # # . . . # . #
# . . . . # # # . # # #
# . . # . . # . . # . #
# . # . # . # # . . # #
# # . . . . . . . . . #
# . # . # . . . # . . #
# . # # . . . . . . . #
# # . . . # # # . . . #
# . . . . . . . . # . #
# . . x x . . # # . . #
# # # # # # # # # # # #
