# # # # # # # # # # # #
# . . . . . . . . . . #
# # . . . . . . # . . #
# . . . . . . . . # . #
# . . . . . . x . # # #
# # . . . . . . . . . #
# . . . . . . . . . . #
# . . . . . . . . . . #
# . . # # . . . . # . #
# . . . . # . . # . . #
# . # # . # . . x . . #
# # # # # # # # # # # #
