# # # # # # # # # # # #
# . . . . . . . # . # #
# # . . . . . . . . # #
# . . . # # . . x # . #
# . . . x . . . . . . #
# # # # # . . . . . . #
# . # . . . . . # . . #
# . . . . . . # . . . #
# . . . . . . . . . . #
# # . . # x . . x . . #
# # . . # . . . . . . #
# # # # # # # # # # # #
