# # # # # # # # # # # #
# . x . . . . . . # . #
# . . . # # . . . # . #
# . . . . . . # x . . #
# . # . # . . # x . . #
# . . . . . . . . . . #
# . . # . # . # # # . #
# . . . . . . . . . # #
# . . . . . # . . . x #
# . . . . . . # # . # #
# . . # . . # . . . . #
# # # # # # # # # # # #
