# # # # # # # # # # # #
# . # . . . . . . # # #
# . . . . . . x . . # #
# . . . . # . . . . . #
# . . . . . # # . . . #
# . # . # # . . . . . #
# . . . . . . . . . . #
# . . . . . . . x . x #
# . # . . . . . . . . #
# . . . . # . . . . . #
# . . . . . # # . . . #
# # # # # # # # # # # #
