# # # # # # # # # # # #
# . . . . . . . . # . #
# . . . . . . . . . # #
# . . . . . . . . # . #
# # . . . . x # . . # #
# # . . . . . . # . . #
# x . . . x . . . . . #
# . # . . . . . . . . #
# . . . . . . . x . . #
# . . . . . # . . # . #
# . . . . . . . # . . #
# # # # # # # # # # # #
