# # # # # # # # # # # #
# . . # # . . . . . # #
# . # . . # . . . # # #
# . . . . . . # # . . #
# . # . # # . . # # x #
# . # . x . # . . # # #
# . . # . # . # . x . #
# # # . # . . . . # # #
# # . # . . # . . # # #
# . # . . . . . . . # #
# . # . # . . # . . . #
# # # # # # # # # # # #
