# # # # # # # # # # # #
# . . . . . . . . . . #
# # . . . . . . # . . #
# . . . . . # . # . . #
# . . . . . . # . . # #
# . . . . . . . # . . #
# # . . . # . . # . . #
# # . . . . . . x . # #
# . . x . . # . . . . #
# . . . . # . # . # . #
# . . . . # . . . . . #
# # # # # # # # # # # #
