# # # # # # # # # # # #
# . . . # # . . . . . #
# # . # . # # . . . . #
# . . . . . . # . . . #
# # # . # . x . # . . #
# . . # . . . . . # . #
# . . # . . . . . . . #
# . # x # . . . . . . #
# # . . # # . . . . . #
# # # . # . . . . x # #
# . . # . # . . . . . #
# # # # # # # # # # # #
