# # # # # # # # # # # #
# . . . . . . . . . . #
# . . . . . . . . . . #
# # # x . . . . . # . #
# # x . . . . . . x . #
# . . # . . . . . . . #
# # . . . . . . . . # #
# . . . . . . . . . . #
# . . x . . . # . # . #
# . . . . . . # . . . #
# # . # . . . # . . . #
# # # # # # # # # # # #
