# # # # # # # # # # # #
# . . . x . . . . . . #
# . . . . . . . # # . #
# . . . . . . . . # . #
# . . # . . . . . . # #
# # . . # . . . . . . #
# . . . x . . . . . # #
# # # . . . . # . . # #
# . # . # . . . . . . #
# . # . . . . . # # . #
# # # . . . . . . . . #
# # # # # # # # # # # #
