# # # # # # # # # # # #
# . x . . . # . # . . #
# . . . # . # # . . . #
# . . . . # # . . . . #
# . # . . . . . . . . #
# # . # . . . . . . # #
# . . . . # x x . . # #
# . # . . . . . # . x #
# . . # . . . # # . . #
# . . . # . . . . . . #
# . . . # . # # . . . #
# # # # # # # # # # # #
