# # # # # # # # # # # #
# . . . . . . . . . . #
# . . . . . . . . . # #
# . . . . # . # . . . #
# x . . . . . . . . . #
# . . . . . . . . . x #
# . . # . . . . . . . #
# . . x . . . . . . . #
# . . . x . . . . . . #
# . . . . . . . . . . #
# # . # # . . . # . . #
# # # # # # # # # # # #
