# # # # # # # # # # # #
# . . . # # . . . . . #
# . . . . . . . # . . #
# . . . . . # # . . # #
# # . . . . . . . . . #
# . . . . . . . . # . #
# . . . # . # . . . x #
# # . . . . x . . . . #
# . . . . x . . . . . #
# . # . . . . . . . . #
# . . . . x . . . . . #
# # # # # # # # # # # #
