# # # # # # # # # # # #
# . . . . # . # # . . #
# . # . . . . # . . . #
# # . . . # . . . . . #
# . # . . . # . # . . #
# # . . . x # . . # # #
# . . . . . . # # . . #
# . . . . . . . . . . #
# . # # . # . . # # . #
# . . . . . x . . . . #
# . . # . # . . # . . #
# # # # # # # # # # # #
