# # # # # # # # # # # #
# . . # # . # . . # . #
# . . . . . . . . . # #
# . . . . . . . . . x #
# . . . . . . x . . . #
# # . . . . . . . . # #
# . . . . . . . x . . #
# . . . . . # . . . . #
# # # . . . . . . . . #
# . . . . . . . x . . #
# . . . # . . . # . . #
# # # # # # # # # # # #
