# # # # # # # # # # # #
# . . # . . . # . x . #
# . . . # . . . . . # #
# . . . . . . . . . # #
# . . . # . . . . . . #
# . . . . . . # . . . #
# . . . # . . . . . . #
# . . . . . . . . . . #
# . . # . . . x . . . #
# . . . . . . # x . . #
# . . # . . . . . . . #
# # # # # # # # # # # #
