# # # # # # # # # # # #
# . # . . # . . # . . #
# . . # . # . # . . . #
# . . . . . # . # . . #
# . . # . . . . . . . #
# . . . . . . # . # . #
# # # . x . . . . . . #
# . . . # . . . . . . #
# . . . . . . # . . # #
# . . . # . . . # . . #
# x . . . # . . # . . #
# # # # # # # # # # # #
