# # # # # # # # # # # #
# . . . # . . . # # # #
# # . . . . . . x . . #
# . # . . . . . . . . #
# . . . . # . # . # . #
# . . # . . . . . . . #
# . . . . . . # # . . #
# # . . . . . . x . . #
# . . . . . . # # . . #
# x . . # . . # . . x #
# # . # # # . . . . . #
# # # # # # # # # # # #
