# # # # # # # # # # # #
# . # . . . . . x # . #
# . . # . . . . . . . #
# . . # . # . # . . . #
# . . . . . # . . # . #
# # . . x x . . . . # #
# . . . # # . . # . . #
# . . . . . . . . . . #
# . . . . . . . . . # #
# . # . . . . . . # . #
# . # . . . . . . . . #
# # # # # # # # # # # #
