# # # # # # # # # # # #
# . # . . # # # . # . #
# . . . . . # . # . . #
# . . . # . . . # . . #
# . . . . # . . # . . #
# # . . . # . . # # . #
# . . . . . . . . . . #
# . . . . # . . x . # #
# # # . x . # . . . . #
# x # . . # . . . . . #
# . . . . . . . # # . #
# # # # # # # # # # # #
