# # # # # # # # # # # #
# . . . . . . . . . . #
# # x . # . # . . . . #
# . . # . . . . . . . #
# . # . . . . # . . . #
# . # . # . . . # . # #
# . . . # . . . . . . #
# . . . . . . . . . # #
# . . . . # . . . . . #
# . x . . . x . . # . #
# . . . . . . . . . . #
# # # # # # # # # # # #
