# # # # # # # # # # # #
# . . # . . . . . . . #
# . . # . # . . . . . #
# . . . . # . # # # . #
# . . . x # . . . . . #
# . . . . . . # . . . #
# . . . . . . . . . # #
# . . # . . . . . # . #
# x . . . . # . . . . #
# . . . # x . x # . . #
# . . . # . # . . . . #
# # # # # # # # # # # #
