# # # # # # # # # # # #
# . # x . # # . . . . #
# . . . . . . . . . . #
# . . # . . # . . . . #
# . . . . . . . . # . #
# # . . . . # . # . . #
# . . . # . # . . . . #
# x . # . . . . . . # #
# . # . . . # . . . . #
# . . . . # . . # . . #
# . . . . . # . # . . #
# # # # # # # # # # # #
