# # # # # # # # # # # #
# . . # . . . . # . . #
# . . . . . . . . . . #
# . . # . . . . . # . #
# . . . . . # . . . . #
# . . # . . . . . . . #
# # # . . x . . . . . #
# . # . . . # # . . . #
# . # # . . # . . x . #
# . . x . . . . . . . #
# . . . . # . # # . . #
# # # # # # # # # # # #
