# # # # # # # # # # # #
# . . . . . . . . . . #
# . . . x . . # # . # #
# . . . . . . . x . . #
# . . . . # # # . . . #
# . . . . . . # . . . #
# # . . . . . . . . . #
# . . . . . # . . . . #
# . . . . . . # . . # #
# . . . . # . . # # . #
# # . . . . . . . . . #
# # # # # # # # # # # #
