# # # # # # # # # # # #
# . . . . . . . # . # #
# . . . . # . . . . x #
# . . . . . . . . . . #
# . . x . . . . . # # #
# . . . . . . # . . . #
# . . x . . . . . . . #
# # . . . . . . . # . #
# # . . # . . . # . # #
# . # # . . . . . # . #
# . # # . . . . . . . #
# # # # # # # # # # # #
