# # # # # # # # # # # #
# . . . . # . . . . . #
# . # . # . # # . x . #
# # # . # . # . # x . #
# . . . # . . # . . . #
# . . # # . # # . . . #
# . . . # . . . . . # #
# # # . . . . # . . . #
# x . x . . # . . . . #
# . # # . . . # . . . #
# . # . . . # . # . . #
# # # # # # # # # # # #
