# # # # # # # # # # # #
# . . # . . # . . x . #
# . . # . x # # # . . #
# . . . . # . . . # . #
# . . . . # . . x . . #
# . # . . . . . # . . #
# # . # . . . x . . . #
# . # # . . # . . . . #
# . # . . # # . . . . #
# . . . . . . . . # . #
# . . . . # . . . . . #
# # # # # # # # # # # #
