# # # # # # # # # # # #
# . . . . . . x . . . #
# # . . . . # # . . . #
# # . # . # . . . . . #
# . . # # . x . # . # #
# . # . . . . . . . . #
# . # . # # # # . . # #
# . # . . . . . . x . #
# . . . # . . # . # # #
# # # # . . . # . . . #
# # . # . # . # . # . #
# # # # # # # # # # # #
