# # # # # # # # # # # #
# . . . # # . . . # . #
# . . . . . . . . . . #
# . . . . . . # . . . #
# . . . . . . . # # . #
# . . . . . . . . . . #
# # # . . . # . . . x #
# . . . . . . . . x . #
# . . . . # . . . . . #
# # . . . . . . . # . #
# . . . . . . . . . . #
# # # # # # # # # # # #
