# # # # # # # # # # # #
# . # . # # . . # . . #
# . . . . . . . . . . #
# . . # . # . # . . . #
# . . . . . # . . . . #
# x . # . # . . . . . #
# . . . # . . . . # . #
# . . . . . . . . . . #
# . . . . . . . . # . #
# . . . # . . . . . . #
# x # . . . . . . . . #
# # # # # # # # # # # #
