# # # # # # # # # # # #
# . . . . . . . . . . #
# . . . . . . . . . . #
# . . . . . . . . . . #
# x . # . . . . # . . #
# . . . . # # . # . . #
# . . . x # . . . . . #
# . . . . . . . . . . #
# # . . . . . # . # . #
# . x . . # . . . . . #
# # . . . . . . . x . #
# # # # # # # # # # # #
