# # # # # # # # # # # #
# . # # . . . # # # . #
# . . . . . . . . . # #
# . # # . . . . . . # #
# x . . . . # # . . . #
# . . . . . . . # . . #
# . . . # . . . # . . #
# . . # . # . . # . . #
# . # . . . . x . # . #
# . . . . . # . # . . #
# . . . . . # # # # . #
# # # # # # # # # # # #
