# # # # # # # # # # # #
# . . # # . . # . . . #
# . # # # . . . . . # #
# . . . . x . . . . . #
# # x . . . . . # . . #
# . . . . . # . . . # #
# . . # . . . . . . . #
# . # . . # . . . . . #
# # . . . # . # . . . #
# . # . # . # # # # . #
# # # # . . # . . . . #
# # # # # # # # # # # #
