# # # # # # # # # # # #
# . # # . . # . . . # #
# . . . . . x . # . . #
# # . . # . . # . . . #
# # . . . x . . . . x #
# # . . # # # . # . . #
# # # # # . # . . # . #
# # . . . . . . . . . #
# . . . . . . . . . . #
# # . . . . . # . . # #
# . . # # # . . . . . #
# # # # # # # # # # # #
