# # # # # # # # # # # #
# . . . . . . . x # # #
# # . . . . . . . . # #
# . . . . . . . . x . #
# . . . . # . . . . # #
# . . # # . . x . # . #
# . . . . . . . . . . #
# . . . . . . . . . . #
# . . . . . . . . . . #
# . # . . . . . . . # #
# # . . . . . . . . . #
# # # # # # # # # # # #
