# # # # # # # # # # # #
# . . . . . . # . . . #
# . . # . . # . . . # #
# . . . . . . . . . x #
# # # . . . # . # . . #
# . . . . . . . . . . #
# . . # . . . . . . . #
# . . . . . . # . # # #
# . . . # . # # # . # #
# . . . . . . . . . . #
# . . . . . . . x . . #
# # # # # # # # # # # #
