# # # # # # # # # # # #
# . x . . # . . . . . #
# . x # . . . . # . . #
# . . # # . # . . . . #
# . . . . # . . # # . #
# # # . . . . . . . . #
# . . . . . . . . . # #
# . . . # . # . # . . #
# . . . . . . . # . . #
# . # . . . . . # x . #
# . . . # # . . . . . #
# # # # # # # # # # # #
