# # # # # # # # # # # #
# . . . . . . x # . # #
# . # . . . # . . . . #
# . . # . . x . # . . #
# . . . # . . . . . . #
# . . # # . . . # . . #
# . . . . # # . # . . #
# . . # . . . . . . . #
# . . . # # # . . # # #
# . . . . . . x . . . #
# . . # . . . . . . . #
# # # # # # # # # # # #
