# # # # # # # # # # # #
# . . # . . . . . . # #
# . . . . . . . . x # #
# # . . . . . . . # . #
# # . . . . . . . # . #
# # . . . . . # . . . #
# . . . # . . . . . . #
# . . . . . . . . . # #
# # . . . # . . . . . #
# . . . . x . . . . # #
# # . . # . # . # . . #
# # # # # # # # # # # #
