# # # # # # # # # # # #
# . . # . . . . . . . #
# . . . . . . . . . . #
# # . . . # # . . . . #
# . . . # . . # x . . #
# . . . . . . . . . . #
# # . . . # . . . # . #
# . # x . # . . # . . #
# # . . . . . . . # # #
# # . . # . . . . . # #
# . . . . . . . . . . #
# # # # # # # # # # # #
