# # # # # # # # # # # #
# . . . # . # . . . . #
# . # . . . x . . . . #
# # . . . # . . . . # #
# # . . . . # . . # # #
# . . . . . # . . . . #
# # . # . . # . . . # #
# . . . . . . . . . . #
# . . . . # . . . # # #
# # # . . # . . . . x #
# . . . # . . . # . . #
# # # # # # # # # # # #
