# # # # # # # # # # # #
# . . # . . . . . . . #
# . . . . # . . . # # #
# # . . # . . # . # # #
# . x . . . . # . . . #
# . # x . # . . # . . #
# . . . . . # . . . # #
# . # . . # . x . . . #
# # . # . # x . . . . #
# . . . # # . . # . . #
# . # . . # . # # . . #
# # # # # # # # # # # #
