# # # # # # # # # # # #
# . . . . . . . . . . #
# . . . . x . . # . . #
# . # . . # . . # . # #
# . . . . . # . . . . #
# # . . . . . . # . . #
# . # # # . . . # . # #
# . . . . . . . . . # #
# . . . . . . . . . . #
# # . . . . . # . . # #
# # . . # . . # . . . #
# # # # # # # # # # # #
