# # # # # # # # # # # #
# . . # . . . . # . . #
# . . . # . . . . . . #
# # . . . . # . # . . #
# . . . . . x . . . . #
# . . x . . . . . . . #
# . . . . . . . . . . #
# . . . . . . . . . . #
# . . . . . # . . # . #
# . . . . . . . . # . #
# . . . . . . # . . . #
# # # # # # # # # # # #
