# # # # # # # # # # # #
# . . # # . . . . # . #
# . . # # . . . # . . #
# . x . # . # . . . . #
# . x # . # . x . . . #
# . # . . . . . . . . #
# . . . . . # # . . . #
# . . . # . . . # . . #
# # . . # . . # . # . #
# # # . # . # . . . . #
# . # . # . . # . . . #
# # # # # # # # # # # #
