# # # # # # # # # # # #
# . . . . . . . # . . #
# . . . # # . . . . # #
# . . # # # . . . . x #
# # . . . . . . . # . #
# . . . . . . . . . . #
# . # # . . . . . # . #
# # . . . . . . . . . #
# # # . . x . . . . . #
# . . . . # . . . # . #
# . . . . . x . # . . #
# # # # # # # # # # # #
