# # # # # # # # # # # #
# . . # . # . # . . # #
# . . . . . . # . # . #
# . . . . # . . . . . #
# . . . . . x # . # . #
# . . . . # # # . . . #
# # . . . # . . . # # #
# . # . x . . . . # # #
# . # . # . # . . . . #
# . . . . . . x . . . #
# . . . . x # . # # . #
# # # # # # # # # # # #
