# # # # # # # # # # # #
# . # # # . . . . # . #
# . . . # . . . . . . #
# . . # . . # # . . . #
# . . . # . . . # . . #
# . # . . . . # . # . #
# . . . . . . . . . . #
# # # . . . . # . . . #
# . . . x . . # . x x #
# # . . . . . . . . . #
# # . . . # . . . . . #
# # # # # # # # # # # #
