# # # # # # # # # # # #
# . . . . . # . . . . #
# . . . # . . . . . # #
# . # # . . . # . . . #
# . . . . . . . . # # #
# # # . . . x # . . # #
# . . . . . . . . # . #
# . . x . # . . . . . #
# # . . . . . . . . . #
# # # . . . . . . # . #
# . x . . . . # . . . #
# # # # # # # # # # # #
