# # # # # # # # # # # #
# . . . # . . # . # . #
# . . . . . . . . . . #
# . . . # . . . . # x #
# . . . . . . # . . . #
# # . . . . . x # . . #
# . . # . . . # . # . #
# . # . . . . # # # . #
# . # . . # . . . . . #
# # # . . # . . # # . #
# # . # . . . . . . . #
# # # # # # # # # # # #
