# # # # # # # # # # # #
# . . # . . . . # . # #
# # . # # # . # # . . #
# # . . # . # # . . . #
# . x . . # . x # . . #
# . # . . . . . # # # #
# . # . . # . . . . # #
# . . . # # . . . # . #
# . . . . . # . . . . #
# . # # # . # . # . . #
# . # . . # . . . . . #
# # # # # # # # # # # #
