# # # # # # # # # # # #
# . x . # . # . # . . #
# . . . . . . . . . . #
# . # . # . . . . # . #
# . . . . # . . . . . #
# . . . . . . # . . . #
# . . . . . # . . # . #
# . . . . # . # . . . #
# . . . . . . . # . . #
# # # . # # # . . . . #
# x . . . . . . . . . #
# # # # # # # # # # # #
