# # # # # # # # # # # #
# . . . . . . . . # . #
# . . . . x # # . # . #
# . . # . . . . . . . #
# . . . . . . . . # . #
# . . . . . . . . x # #
# # . . . . . . . # . #
# . . . . . . . . . . #
# . . . . . . . x . # #
# . . . . . . . . . . #
# . . . . . . . x . . #
# # # # # # # # # # # #
