# # # # # # # # # # # #
# . . . . . . . . . . #
# . . . . . . . . . . #
# . . . . . . . . . . #
# # . # . # . . . . # #
# . # . . . # # . . # #
# . # . # . . # . # . #
# # . x . . . . . . . #
# . . . . . # . . . . #
# . # . . . x # . x . #
# . . . . . . . . . . #
# # # # # # # # # # # #
