# # # # # # # # # # # #
# . . . . . . . # . . #
# . . . . . . . . . # #
# . . . . # # . . . # #
# . . # . . . . # . # #
# . . . . # . . . . # #
# . . . . . . . . . . #
# . . . . . . . . . x #
# . . . x . . . . . . #
# . . . . . . . . . . #
# . . # . . . . # . . #
# # # # # # # # # # # #
