# # # # # # # # # # # #
# . . x . # . # . . x #
# . # . . . . . . . . #
# . . . . . . . . . . #
# . . . # . . . . . . #
# . x # . . . . # . . #
# # . . . . . . . . . #
# . . . . # . . . . # #
# . . . . . . # . . . #
# . # . . . x # . . . #
# . # . . . . . . . . #
# # # # # # # # # # # #
