# # # # # # # # # # # #
# . x # . . # . # # . #
# . # . # . . . # . x #
# . . . . # . x # # . #
# . # . . . . . . . . #
# . # . . . . x . # . #
# . . . . . # . . # . #
# . . . . . . # . # # #
# . # . . . . . # . . #
# . . . # . # . # # . #
# . . . . . . . . . . #
# # # # # # # # # # # #
