# # # # # # # # # # # #
# . . . . # . . . # # #
# # x # . . . . . . . #
# . . . . . . . . . # #
# . . . . # x . # . # #
# . . . . . . . . . . #
# . # . # . # # . . . #
# . . . . . # . . . . #
# # # # . . . . . . . #
# . # . . . . . . . . #
# # . # . . . . # . . #
# # # # # # # # # # # #
