# # # # # # # # # # # #
# . . # . . . # . # . #
# . . . # . . . . x x #
# # # . . # # . # . # #
# # . . . . # # # # # #
# # . . # # . . . . . #
# . . . . . . . . . . #
# . # . # # . . . . . #
# # . # # # . # . # # #
# . . . . . # . . . . #
# . # # # . . # . . . #
# # # # # # # # # # # #
