# # # # # # # # # # # #
# . . . . . . . . . . #
# x . . # . . . # . . #
# . . . # . . . . . . #
# # . . . . . . # . . #
# . # . . x . . . . . #
# # . . . . . # . . . #
# . . . . . . . # . . #
# . . . . . . . . . . #
# . . . . . . . . . . #
# . . . . . . . . . . #
# # # # # # # # # # # #
