# # # # # # # # # # # #
# . . . . # # . . . . #
# . . . # . . . # . . #
# # . . . # . . . . . #
# # . . . . # . . . . #
# # . # x . . . # # # #
# . . # . . . . . . # #
# # . . . x . # . # . #
# # . . . . # . . . # #
# . . . . # # # # . . #
# # . . . . . # # # . #
# # # # # # # # # # # #
