# # # # # # # # # # # #
# . . . . . . . . . # #
# . # . x . . x . . . #
# . . . . . # . # . . #
# . . . . . . . . . . #
# . . . . . . . # . . #
# . . . . # # . . . . #
# . . . . . # . . . . #
# . . . . . . . . # . #
# # . . . . . . . . . #
# . # . x . # . . # . #
# # # # # # # # # # # #
