# # # # # # # # # # # #
# . . . . . x . . . . #
# . . # . # # # # . . #
# . . . . # . . . . . #
# . . . . # # . . . . #
# . . . . . # # . . . #
# . . . # # # . . # # #
# . . . . . . . . x . #
# . . . . . . # # . # #
# . . . x # . . . . . #
# . # . # . . . . . . #
# # # # # # # # # # # #
