# # # # # # # # # # # #
# . . . . . . . . . . #
# # # # . . . . # . # #
# . . . . . . . . . # #
# . x . . x # . . . . #
# . . . # . . . # . . #
# # . . . # . . . . . #
# # . . . . # . . . . #
# . . . . . . . . . . #
# # # . . # . # # # # #
# x . . # . . . . . . #
# # # # # # # # # # # #
