# # # # # # # # # # # #
# . . . . # . . . . . #
# . . . . . . . . . . #
# . . . . . . . . . # #
# . . . . . . . . . # #
# . . # . # . . . . # #
# . . . . # . . . x . #
# . . # . . . . . . . #
# . . . . . . . . . . #
# . x . . . x # . x . #
# . # . . # . . # . . #
# # # # # # # # # # # #
