# # # # # # # # # # # #
# . # . . . . . # . # #
# . . # # # . . . . # #
# . . . # . . . . # . #
# . . . . . # # . . . #
# # . . . . . . . . . #
# . . . . # . # . # . #
# . . . x # . # . . . #
# . . . . . x . # . . #
# . . . . . . . . # # #
# . x . . . . . . . . #
# # # # # # # # # # # #
