# # # # # # # # # # # #
# . # . . . . . . . . #
# . # # . . . . . . # #
# . x # . . . # . # . #
# . # . # # . . . . . #
# . x . . . . . . . . #
# . . . . # . . # # # #
# . . . . . . . . . . #
# . . . # # . . . . . #
# . # . . # x . . # . #
# . . # # . . . . . . #
# # # # # # # # # # # #
