# # # # # # # # # # # #
# . . . . . . . . . . #
# # . . # . . . . # . #
# . . # x . . . . . . #
# . . . # . . # # . # #
# # . . # . . . . # # #
# . # . # x # # # . # #
# # # . . . # . . . # #
# . . . # . . . . . . #
# . . . . . . . . . # #
# . . . # . # . . . . #
# # # # # # # # # # # #
