# # # # # # # # # # # #
# . # x # . # . . . . #
# . . # . . . . . . . #
# # . . . # . . # . . #
# x . . . . . . . . . #
# . # # . . . . . . . #
# . # . . . # . . # . #
# . . # . . . # . . . #
# . . . # . . x # . . #
# . . # . . . . # # . #
# . . . . x . # . . . #
# # # # # # # # # # # #
