# # # # # # # # # # # #
# . . . . . . . # . . #
# . # . # . . . . . . #
# . . . . x . . # . . #
# . . # . . . . . . . #
# . . . . . # . . . # #
# . . . . . . # . # . #
# . . . . . # . . . x #
# . # . . . . . . . # #
# . # . . # . . . . . #
# # . . . . . # . . . #
# # # # # # # # # # # #
