# # # # # # # # # # # #
# . . . . . # # . # . #
# . # . . . . . # . . #
# . # . # # . . . # # #
# # # . x . . # . # # #
# . x # . # . x . . . #
# . . . . . . . # . . #
# . . # . . # . . . # #
# # . . . # # . # # # #
# . # . # # . . . # . #
# . # . . # . . . . . #
# # # # # # # # # # # #
