# # # # # # # # # # # #
# . . . . . # . . . . #
# . # . . . . . . . . #
# # . . . . . . # . . #
# . . # . . . . . . . #
# . . . . . . # . . . #
# . . . . . . . . # # #
# . . . . . # . . . . #
# . . . . . . . x . . #
# . . x . . . . . x . #
# . . . . . . . . . . #
# # # # # # # # # # # #
