# # # # # # # # # # # #
# . . # . . . . # # . #
# . # . # # . . . # . #
# . # # . . . # . # . #
# . # . . . # . . . # #
# . x # . . # . . . . #
# . . . # . . . . . . #
# . . . . . . . . . . #
# . . # . # x . . . . #
# . # . . . . # . . . #
# # . . . . . . # . . #
# # # # # # # # # # # #
