# # # # # # # # # # # #
# . # . . . . . # x . #
# . . . . # . . . . . #
# . x . . . . . . # x #
# . . . # . . . . . . #
# . . . . . . . . . . #
# . . . . # . . . . # #
# . . . # . . . . . . #
# . # . . . . . . . . #
# . . . . . # . . # . #
# . x . . . . # . . . #
# # # # # # # # # # # #
