# # # # # # # # # # # #
# . # . . . . . . . . #
# . . . . . . # . # . #
# . . # # . . . . # . #
# . . . . . . . . . . #
# . . . x . . # . # . #
# . . x . . . . # . . #
# . . # . . # . . . . #
# . . . . . . # . . . #
# # . . # . . . . . # #
# . . . . x # . # . . #
# # # # # # # # # # # #
