# # # # # # # # # # # #
# . . . . . . . . # # #
# x . . . . . . . . . #
# . # . # # # . . . . #
# # . . . . . . . . . #
# . . # . . # . # . . #
# . . . # . . . # . . #
# # . . . . . # . . . #
# . . x . . . # . . . #
# . . . . . . . . # . #
# # . . . # # . x . . #
# # # # # # # # # # # #
