# # # # # # # # # # # #
# . . . # # . . # . # #
# . . . . . . . # . # #
# . . x . . . . . . . #
# # # . # . . . # . # #
# x . # # # . # . . . #
# . # . . . . . . . . #
# . . # . # # # . . # #
# . . # # . x # # . . #
# # . . . . . . . # . #
# . x # # # # . . # . #
# # # # # # # # # # # #
