# # # # # # # # # # # #
# . . . . . . . . . . #
# . . . # . . . . . . #
# . . # # . . . . . # #
# . . . . x # . # . . #
# . . . # . # . . . . #
# . . . . . . . . . . #
# . . . . . . . . . . #
# # . . . . # . . . x #
# . . . # . . . . . . #
# . . . . . . . # . . #
# # # # # # # # # # # #
