# # # # # # # # # # # #
# . . . . . . . # . . #
# . . . . . . . . . x #
# . . . . . . . . . . #
# . . . . . # # . . . #
# . . # # . . . . . . #
# # . . # . . . . . . #
# . . . . # . . # . . #
# . . . # # . . . . x #
# . . . . . . . . . . #
# . . # . . . . . . . #
# # # # # # # # # # # #
