# # # # # # # # # # # #
# . . x . . . # . . . #
# # . . # . . . # . . #
# . # . # . . . . # . #
# . . . . . . . . . . #
# . . . . . . . . x . #
# . . . . . . . . . . #
# . . . . . . . . . . #
# . . . . # . . . . . #
# . . . . . . . . . # #
# . . # x . . . . . . #
# # # # # # # # # # # #
