# # # # # # # # # # # #
# . . # . # . . . . . #
# . . . . . . . . . . #
# . . . . . . # . . # #
# . . . . # . # # . . #
# . . . . # . . . . . #
# . . x . . . . . . x #
# . . . . . # . # . . #
# . . . . . . . # . . #
# . x . . . . . . . . #
# x . . . . . # . . . #
# # # # # # # # # # # #
