# # # # # # # # # # # #
# . . . . . . . . # . #
# . # . . . . . . . . #
# . # # . . . # . # . #
# . . . . . # . . . x #
# . # . # . . . . . . #
# . . . . . # . . x . #
# . . . # . . . . # # #
# . . . . . . . # . . #
# . . . . # . # . . . #
# # # . # . . . . . . #
# # # # # # # # # # # #
