# # # # # # # # # # # #
# . . . # . . . . . . #
# . . . . . . # . . . #
# . . # # . . . . . . #
# . . . . # . . . # . #
# . . . . . x . # . . #
# . . # . . . . . . . #
# x . . . . . . . . . #
# . . . . # . . # . . #
# . . . . . x . . # . #
# . # # . . # . . . . #
# # # # # # # # # # # #
