# # # # # # # # # # # #
# . # . # . . . . . . #
# . . . . . . . . . . #
# . . . . . . . . # . #
# # x . . # # . # . . #
# # . # . . . . # . . #
# . . # # # . # # . # #
# # . . # . . x . . . #
# . . . . # . . . . . #
# # . . . . . . . . . #
# . . . # . # . # . . #
# # # # # # # # # # # #
