# # # # # # # # # # # #
# . . . . . . . . . . #
# # . # . x . . . . . #
# . . . . # # . . . . #
# . . . . . . . . . # #
# . . x . . . . x . . #
# # . . . . . . . . . #
# . # . # # . # . . . #
# . . . . . . . . . . #
# . . . . . . . . . . #
# . . . . . . . . . . #
# # # # # # # # # # # #
