# # # # # # # # # # # #
# . . . . . . . . . # #
# . . . # x . . . . . #
# . . . . . # . . . . #
# . . . . . . . . . . #
# . . . . . . . . . . #
# . . . . . . . . . # #
# . . . # . . . # . . #
# # . # . . . . . . x #
# . x . . . . . . # x #
# . . . . . . . . . . #
# # # # # # # # # # # #
