# # # # # # # # # # # #
# . . . # # . . . . . #
# . . . . # . . . . . #
# . # # # . # # . . . #
# . x . . . . . . . . #
# . . . . . . . . # # #
# . . x # . # # . . . #
# # . . . # . . . x # #
# . . . . # . # . . . #
# . # . # . . # . . # #
# # . . # . . . . . . #
# # # # # # # # # # # #
