# # # # # # # # # # # #
# . . . . # . . # # # #
# . # # # . . x . # . #
# . # x . . # # . # # #
# . # . . . . # . # # #
# . . # . . . # # . # #
# # . # # . . # # . # #
# # . . x # # x . # . #
# . . . # # . . . . . #
# # . . . . . . . . . #
# . # . # . # . # . . #
# # # # # # # # # # # #
