# # # # # # # # # # # #
# . . # . . . . . . . #
# . . . . . . . . # # #
# . # . # . . . . . . #
# . . . . . . . . . . #
# . # . . . . . . x . #
# # . # . . . . . . . #
# . . . . . # # # . # #
# . # . . . x . . # . #
# # # . # # . . . . . #
# . # . . . . . . . . #
# # # # # # # # # # # #
