# # # # # # # # # # # #
# . . . . . . . # . . #
# . . . . . . # . . # #
# # . # . . . # . . . #
# . . # . . . . x . . #
# # . . # # . . . . . #
# . . . . # . . . . . #
# . . x . # # . . # . #
# # # # . . . # # # . #
# . . . . # . . # # . #
# . . . . # . # # # . #
# # # # # # # # # # # #
