# # # # # # # # # # # #
# . . . . . . . . . . #
# . . . . . . . . # . #
# . # . . # # . . . . #
# # . . . . x # . . . #
# . . . . . . . # . . #
# . . . . . . . . . . #
# . . . . . . . . . . #
# . # . . # # . . . . #
# . . . . . . # . . # #
# . . . x . x . . . . #
# # # # # # # # # # # #
