# # # # # # # # # # # #
# . . . . . x . . . . #
# . . . . # . # . . # #
# . . . . . . x . . . #
# . . . . # . . # . . #
# . . . . . # . . . . #
# . . . . . . # . . . #
# # . # . . . . . . . #
# . . . . . # . . . . #
# . . . . . . . . # . #
# . . . . # . . . . . #
# # # # # # # # # # # #
