# # # # # # # # # # # #
# . . x . . x . . . # #
# . . # . . . . . . . #
# . . . . # . x . . . #
# . . . . . . . . . # #
# . . . . # # . . . . #
# . . . . . # . . . . #
# . . . # . . . . . . #
# . . . # . . # . . # #
# . . . . . . . . . . #
# . . . . . . . . . . #
# # # # # # # # # # # #
