# # # # # # # # # # # #
# . . . . . . . . . . #
# . . . . . . . . . . #
# # . . . . . # . x # #
# . . # . . # . x . . #
# . . . # . . # . . . #
# . . . . x . . # . . #
# # # . # . # . . . . #
# x # . . . # . . # # #
# . . . # . . . . . . #
# . . # . . . . . . . #
# # # # # # # # # # # #
