# # # # # # # # # # # #
# . # x # . x . # . # #
# . # . . . . . . . . #
# . # . . . . # . . . #
# . # . . . . . . . . #
# . . . . # # . . . # #
# . . . . . # . # . # #
# # . . # . . # . . x #
# # # . . . . . # . # #
# # . x . . . # . . # #
# . # . # . . . # . . #
# # # # # # # # # # # #
