# # # # # # # # # # # #
# . . . . . . . . . . #
# # # . . . . . . # . #
# # . . . x . . # . . #
# . . x . . # x . . . #
# # . # . . . x # . . #
# . . . . . . . . . . #
# . . . # . . . . . . #
# . . . . # . . . # . #
# # . . . # # # . # . #
# . # . . . # . . . . #
# # # # # # # # # # # #
