# # # # # # # # # # # #
# . . . . . . . . # # #
# . . # x # . . # # . #
# . . # x . . . . . # #
# . # # # . . . # . . #
# . . . . . # . . . x #
# . . . . . . . . . . #
# . . . . . # . # . . #
# . . # . . # # . # . #
# . # . . . . . . . . #
# . . # . x . . . # . #
# # # # # # # # # # # #
