# # # # # # # # # # # #
# . . x . . . . # . . #
# . # # # . . . . . . #
# . . . # . . . . . # #
# # . # . . . . . . # #
# . . . . . . x # . . #
# . . . . . # . # . # #
# . . . . . . # . . . #
# x . . . . . . . . . #
# . # . . # . . . . . #
# . . # . . . # # . . #
# # # # # # # # # # # #
