# # # # # # # # # # # #
# . . . . . . . . . . #
# . # . . . . . . . . #
# . . . . # . # . . . #
# # . . . . # # # . # #
# . # . . # . . x . x #
# # # # . . . # # . . #
# # # . # x . . . . x #
# # . . # . . . . . . #
# # # . # # . . . . . #
# # # . . # # . . # . #
# # # # # # # # # # # #
