# # # # # # # # # # # #
# . # . . . . . . . . #
# . . . . . . . . . # #
# . . . . # x . # . . #
# # . # . . . # . . . #
# . . . . . . . # . . #
# . . . . # x . . # . #
# . . . . . . . . . . #
# # . . . . # # . . . #
# . # . . . . . . . . #
# . . . # . # . # . . #
# # # # # # # # # # # #
