# # # # # # # # # # # #
# . . . . # # x . # # #
# # # . # . . . # # . #
# # # . # # . . # # . #
# . . . . # # # # . # #
# # . . . # . # # . . #
# . . # . . # . . . # #
# # . # . . . # # . . #
# # . # # . # . # # . #
# # # # # . . # . . . #
# . # . . . . . . x . #
# # # # # # # # # # # #
