# # # # # # # # # # # #
# . . . . . . . . . . #
# . . . . . . # . . x #
# # . . . . . x . . . #
# . . . . # . # . # . #
# . . . . . . # # . . #
# . . . . . # . . . . #
# . . . . # . # # . # #
# # . . . . . # . . # #
# . . . . . . . . . . #
# . . . x . . . . . . #
# # # # # # # # # # # #
