# # # # # # # # # # # #
# . . . x . . . . . . #
# . . x . . . . . . # #
# . . . . . # . . . . #
# . . . . . . . . . . #
# . . . . . # . . . . #
# . . . # . . . . # . #
# . # . # . . . . . . #
# . . . x . . . . . . #
# . . . # . . . # . . #
# . . # . . . . # . . #
# # # # # # # # # # # #
