# # # # # # # # # # # #
# . . . . . . . . . # #
# . . . . . . . # x # #
# . . . . . . . # . . #
# . . . . . . # # . . #
# . . . . . . . . . . #
# # # . # . # # # x . #
# . . . . . . x # . . #
# . . . . . . . . . . #
# # . . . . . . x . . #
# . . . . # . . . . . #
# # # # # # # # # # # #
