# # # # # # # # # # # #
# . . # . . . # . . . #
# . # . . . x . . . . #
# . . # # . . . . . . #
# . . . # . . # . . . #
# . . # . . # . . . . #
# . # . . x . . x . . #
# . . . . . . . # # # #
# . . . . . . # . . . #
# . x . . . . . . . . #
# . . . . . . . . # . #
# # # # # # # # # # # #
