# # # # # # # # # # # #
# . # # . . . . . . . #
# . # # . . . . . . . #
# . . # . . # x . . . #
# . . . . # . . . . x #
# . . . . x . . . . . #
# x . . . . . . . . . #
# . . . . . . . # . # #
# . . . . # . . . . . #
# . . . . . . . . . . #
# . . . . . # # . . . #
# # # # # # # # # # # #
