# # # # # # # # # # # #
# . . . . . . . # . x #
# . . . . . # . . . . #
# . # # . . . . . . . #
# x . . . . . . . . # #
# # . . . # . # . . . #
# . . . # . # # . # . #
# . . . # . . . . . . #
# . # . . . # . # . . #
# . . . . . . . # . . #
# . . . . # . . . # . #
# # # # # # # # # # # #
