# # # # # # # # # # # #
# . . . . . . . . . . #
# . . . # . . . . . # #
# . . . . . . # # . . #
# . . # . . . . # # . #
# . . . # . . . . . . #
# . . . x . # . . # . #
# . . # . . # . . . . #
# . . . . . . x x . . #
# . . . . . . . . . . #
# . . . . # . # . . . #
# # # # # # # # # # # #
