# # # # # # # # # # # #
# . . # # . . . # . . #
# . . # . # . # x # . #
# # . # # . . . . # # #
# . . . . # . . . . # #
# . # . . # . . # . . #
# . . . . . . . . . . #
# . # . . # . . # # . #
# x # . # . # . . . # #
# . x . # . # . . . . #
# . . # . # x . . . . #
# # # # # # # # # # # #
