# # # # # # # # # # # #
# . . . . . . . # # # #
# . . . . # . . # . x #
# . . . . . . . . . . #
# . . # # . . . . . . #
# . . . x . . . . . . #
# . . . . # . . . # . #
# # . . . . . . . . . #
# . . . . x # . . . . #
# . . . . . # . . . . #
# . . # . . x # . . . #
# # # # # # # # # # # #
