# # # # # # # # # # # #
# . . . . . . # . . . #
# . . x . . . # . . . #
# # . . . # . . . . . #
# . . # . . # . . . . #
# . . . . . . . . . . #
# . . . x . . . . . . #
# . . . . . . . . . . #
# # . . . . # . # . . #
# . # . . x # # # . . #
# . . . . . . . . . . #
# # # # # # # # # # # #
