# # # # # # # # # # # #
# . . . # . . . x . . #
# # . . . . . . . . . #
# . . . # . # . . . . #
# # . . . . x . . . . #
# . . . . . . . . # . #
# # . . . . . . . . . #
# . . . . # . # . # . #
# . . . . # . # . . . #
# . . . . . . x . # . #
# # . # . . x # . . . #
# # # # # # # # # # # #
