# # # # # # # # # # # #
# . # . # . . . . . # #
# . . # x . # . x . . #
# . . # . . . . # . . #
# . . # . # . . . . # #
# . . . # . # # # . . #
# . . # # . # . # # . #
# . . . # . . . # # . #
# . . . # # . . # . . #
# . . . . . # # . . . #
# . . . # . . . . . . #
# # # # # # # # # # # #
