# # # # # # # # # # # #
# . . . # . . . . # . #
# . . . . . . . . . . #
# . . . . . . . . . . #
# # . x . . . . # # . #
# . # # . # . . # . . #
# . . . . . . # . . . #
# . . . . . . . . . . #
# . . . # # x . . # . #
# . . . . # . . . . . #
# . . . . . # . . . . #
# # # # # # # # # # # #
