# # # # # # # # # # # #
# . . . . . # . . . . #
# . . . . . . . . . # #
# . . . . . . . . # . #
# . . . . # # . # . . #
# # . . . . # . # . . #
# . # . . . . . . . x #
# . . . . . . . . . . #
# . # . . . . . . . . #
# . . . . # . x # x . #
# . . # . . . . . . . #
# # # # # # # # # # # #
