# # # # # # # # # # # #
# . # . . . # . . . # #
# . # . . . . # . . . #
# . . # # . . # . # . #
# x . . # . # . . # . #
# . . . # . . . . # . #
# . . . . # # . . . . #
# . # # . . . . # . . #
# . # . . # . # # # . #
# . . . . . . x # . . #
# . . x . . . . . # . #
# # # # # # # # # # # #
