# # # # # # # # # # # #
# . . . . . . . . . x #
# . . . . . . . . . . #
# # . . . . . . # . . #
# . # . . # . # . x . #
# . . . . . . . . . . #
# . . . . # . # . . # #
# . # . . . # . # . . #
# . # . . . . . . . x #
# . # . . . # . . . . #
# . . . . . . # . . . #
# # # # # # # # # # # #
