# # # # # # # # # # # #
# . # . . . . x # . # #
# . . . . . . . # . . #
# . # . . . . . . . # #
# . # . # . . # . . . #
# . . . . # . . . . # #
# # # . . # . # . # . #
# . # # # . . . x . . #
# . . . . . . # . . . #
# # . # . . . . # . # #
# . . . . # . . . . . #
# # # # # # # # # # # #
