# # # # # # # # # # # #
# . # . # . . # . # . #
# . . . . x . # . . . #
# . # # . . # . . . . #
# . # . . # # . # x . #
# x . . # . . . . # . #
# . # . . . . . . . . #
# # # # . # . . . # . #
# . # . # . . . . # . #
# . . . . . . # . . . #
# . # # . # . . . . . #
# # # # # # # # # # # #
