# # # # # # # # # # # #
# . # # . # . . . . . #
# . . . x . . x . . . #
# . . . . . . # # . . #
# . . . . # . # . . . #
# . # . x . . . . # . #
# . . . . . # . . . # #
# . # . . # # . x . # #
# # # . . . . . . # . #
# . . . . # . . . . . #
# # # . . . # . # . . #
# # # # # # # # # # # #
