# # # # # # # # # # # #
# . . . . . . . . . . #
# # . . . . . . # . . #
# . # . . . . . . . . #
# . . . . . . . # . . #
# # . . . . # . . . # #
# x . . . . . . . . . #
# . . . # . . . . . . #
# . x . . . . . . # . #
# . . . . . . . . . . #
# . . . . . . . . # . #
# # # # # # # # # # # #
