# # # # # # # # # # # #
# . . . . . . . . . . #
# . . # . . # . . . . #
# . . . . . . . . . # #
# . # . . . # . . # . #
# . . x x . . . . . . #
# . . . . . . . . . . #
# . . # . . . . . . . #
# . . # . . x . . . . #
# . x . . . . . . . . #
# . # . # . . . . . . #
# # # # # # # # # # # #
