# # # # # # # # # # # #
# . # . . # # . . # # #
# . # . . . x x . . . #
# . # . # . . # . . # #
# . . . . . # # . . # #
# # # . # . # # . . x #
# . . . . . # # . . . #
# # # # . # . . . . # #
# . # . . . . . . . . #
# # . # # . . . . . # #
# . . # # . . # . . . #
# # # # # # # # # # # #
