# # # # # # # # # # # #
# . # . . . . . . # . #
# . . . # . # . . x # #
# . . . . # . . . x # #
# . # . . . . . . . . #
# . . . . # . . . . # #
# . . . # . . . # # # #
# . . . # x . . # . . #
# . . . # # . # . . # #
# # . . # # . # . . . #
# . . . # . . . . . . #
# # # # # # # # # # # #
