# # # # # # # # # # # #
# . . . . # . # # . . #
# . . . . . . . . . . #
# . . . . . . # . . # #
# . # x . . . . . # . #
# . . . x . . . . . . #
# . . . # # . x . . . #
# . . . # . . . . . . #
# # # . # # # # . # # #
# . # # . . . . . . . #
# . # . # . . . # . . #
# # # # # # # # # # # #
