# # # # # # # # # # # #
# . . . # . . . # . . #
# . . . . . . . . . . #
# . # . . x # . . . . #
# # . . . . . . . . . #
# . . . . # . . . . # #
# . . . . . . . . . . #
# # # . x . . . . . . #
# . . . . . . . . . # #
# . . . . . . . . . # #
# . . . . . . # . . . #
# # # # # # # # # # # #
