# # # # # # # # # # # #
# . # # . . . . . . x #
# . . . . . # . . x # #
# . . . . . . . . . . #
# . . . . . # . . . # #
# . # . . . . . . . . #
# . . . . . . . . . . #
# x # . . . . # . . . #
# . . . . # # . # . . #
# . . . . . . . . . . #
# . . . # . . . . . . #
# # # # # # # # # # # #
