# # # # # # # # # # # #
# . # . . . . . . . # #
# . . . . . . . . . . #
# . . # # # . . # . . #
# . . # . . x . # . . #
# . . # . . # . . . # #
# # # . # # . . # . # #
# . . # # . . . x . # #
# # # . . # . . . . # #
# . . # . . # . . x . #
# . . . x . # . . . . #
# # # # # # # # # # # #
