# # # # # # # # # # # #
# . # . . . . . # # . #
# . # . . . . . . . # #
# . # # . . . . . . . #
# . . . . . . . . # . #
# . . . . . . . . # . #
# . # . . . # # . . . #
# . . . . . x # . . . #
# . # # . . . # # . x #
# . . . # . # . . # . #
# . # . . . . . . . . #
# # # # # # # # # # # #
