# # # # # # # # # # # #
# . . . . . . . . # # #
# # . . . # . # . . . #
# # # . . . . . . x . #
# # . . . . . . # . . #
# # . . . . # . . # # #
# . # x . . . . . . . #
# . # . . # . # . # . #
# # . . x . # . . . . #
# . . # # # . . # . . #
# # # . . # . . . . . #
# # # # # # # # # # # #
