# # # # # # # # # # # #
# . . . . . . . . . . #
# . # . . . . # . . . #
# . x # . # # . . # . #
# # . # # . . . . # . #
# . . . . . . # . . . #
# # x # # . . . . . . #
# . . . . # # # . # . #
# . . . # # . . . . . #
# . . . . . . . # . . #
# . # . . . . . . x . #
# # # # # # # # # # # #
