# # # # # # # # # # # #
# . . # x # . # # . . #
# . . . . . . . # . . #
# . . # . # # . . . . #
# . . # . . . . # # . #
# . # . . . . # . # # #
# . # x . # # # . . # #
# . . . . . . . . . . #
# . # # . . . . # . # #
# # # . . . # . # . . #
# . . . # . . # . . . #
# # # # # # # # # # # #
