# # # # # # # # # # # #
# . . # . . . . . . . #
# . . . . # . . . # . #
# . . x # . # # . . . #
# . . . . . x . # . . #
# . . . . . . . . . . #
# . . . # . . . . . . #
# . . . . . . . . # . #
# . . . . . . . . . . #
# # . . . . . . . # . #
# . . . . . . . # . . #
# # # # # # # # # # # #
