# # # # # # # # # # # #
# . . . # # . . # . . #
# . . . . . . # . . . #
# # . # . . . . . . # #
# . . . # . # . . . . #
# . . . . . . . # . # #
# # . . . . x # . . # #
# . . . x . . . # . # #
# # . . # . . . . # . #
# . . . . # . . x . . #
# . . # . . . . . . . #
# # # # # # # # # # # #
