# # # # # # # # # # # #
# . . . x . . # . . . #
# . . # # # . . . . . #
# . . . . # . . . . # #
# . . . . . # . # # . #
# . # . . . # . . . . #
# x . . # . x . . . . #
# x . . . . # . . . . #
# . . . . . . # . . . #
# . . . . # . . . . . #
# # . # . . . . . # . #
# # # # # # # # # # # #
