# # # # # # # # # # # #
# . # . . . # . # . . #
# . . . # . . . . . . #
# . x . . # . . # # . #
# . . . . . . . . . . #
# . . . . . # . . . . #
# . . . . . . # . . x #
# # . . . . . # . . . #
# . . . # . . . . . # #
# . . . . . x . . . . #
# . . . . . x . . . . #
# # # # # # # # # # # #
