# # # # # # # # # # # #
# . . . . # . . # . . #
# # # . # . . . . # . #
# . . . # # . # . # . #
# . . . . . . . . . . #
# . . . . . # # x . . #
# . . . # # . # . . x #
# . . . . . # . . . . #
# . . . . . # # . . . #
# . . # . . . . . . x #
# . . x # . . # . . . #
# # # # # # # # # # # #
