# # # # # # # # # # # #
# . . . # . . . . . # #
# . . . . . . . . . . #
# . . x . # . . . . # #
# x # . . # . . . . # #
# # . x . . . . . . . #
# # . x . . . . . . . #
# . # . . . . . . . # #
# . # . # . . # . . . #
# . . . . . . . # . . #
# # . # . . # . # # . #
# # # # # # # # # # # #
