# # # # # # # # # # # #
# . x . # . . . . . # #
# . . . . . x # # . . #
# . . . . . # . . . # #
# . . x # . . . . x . #
# . # # # . . . . # # #
# . . . # . . . . # . #
# . . . . . . # # . . #
# . # # # . . . . . . #
# . . # . . # . . . . #
# # # . . # . # . . . #
# # # # # # # # # # # #
