# # # # # # # # # # # #
# . . . . . . . . . # #
# . . # . . . . . . . #
# # . . . . . . . . # #
# . . # . . # . . x . #
# . . . . . # . . . . #
# # . x . . . . . # . #
# . . . # . . # . . . #
# . . . . . . # . . . #
# . . . . . . . . . . #
# . . . . . . . . . . #
# # # # # # # # # # # #
