# # # # # # # # # # # #
# . . # . # . . # # . #
# . . # . # . . . # . #
# . . . . # # x # . . #
# . # # . . # # . # . #
# # # . . . # . . . # #
# # . . . . x . # . # #
# . . . # x x . # # . #
# . . # . . # . . . . #
# . . . . . . # . . . #
# # . . . . . . . . . #
# # # # # # # # # # # #
