# # # # # # # # # # # #
# . # . . x . . . # # #
# . . . . . . . . . . #
# . # . # . # . . . # #
# . . . # . # # # . . #
# . . . # . . . . . . #
# . # . . . . . . . . #
# . . . . . # . . # # #
# # # . . # . # . . . #
# . . # # # . . . . . #
# . . # x . . . . . . #
# # # # # # # # # # # #
