# # # # # # # # # # # #
# . . x # . . # # . . #
# . # . . . # . . . . #
# . . . . . . . . . # #
# . # . . . # . # # . #
# x . . . # . . # # # #
# . . . . . # . # . . #
# # . . # . . # # . # #
# . # . . # . # . . # #
# # # # . . . . # . . #
# . # . . . . . . . . #
# # # # # # # # # # # #
