# # # # # # # # # # # #
# . x # . . . . # # . #
# . . # . . # . . # . #
# . . . . . # . . . # #
# . . . # # # . . . . #
# . . . . . . . . x # #
# . # . . . . . . . . #
# . . . # # . . . # # #
# . # . . x . . . # . #
# . # . . x . # . . . #
# . . . . # # # . . . #
# # # # # # # # # # # #
