# # # # # # # # # # # #
# . . . . . . . . x # #
# . . # . . . # . . # #
# . . . . . . . . # . #
# . # . # . # . . # # #
# . . . # . x . # . . #
# . . . . . . . . . . #
# . . . . . . . . . . #
# . . . . . . . . . . #
# # # . x . # . # . . #
# . . . x . . . . . . #
# # # # # # # # # # # #
