# # # # # # # # # # # #
# . . . . . . . . . . #
# . . . . . # . . # . #
# . . . . . . # . . # #
# . # x . . . . . . . #
# # . . . . . . . . . #
# . . x . . # . . . . #
# . . . # . . # . . . #
# . . . . . . . . . . #
# x # . x . . . . . . #
# . . . # . # . . . . #
# # # # # # # # # # # #
