# # # # # # # # # # # #
# . . . . . . # # . # #
# # . . # . . . . . . #
# # . . . . . . . . . #
# . . . # . . . . . . #
# . # # . . . . . # . #
# . . . . . # . # . . #
# . . . # . . . . . . #
# . # # # # x . x . . #
# # . . # . . . # # . #
# . . . . # . . . . . #
# # # # # # # # # # # #
