# # # # # # # # # # # #
# . . . # . # . . # . #
# . . . . . # # . . . #
# . . . # . . . . . . #
# . . . . . . . # . . #
# . . # . . . . . . . #
# . . . . # # . . . . #
# # . . . x . # . x . #
# . . . . . . . # . . #
# . . . . . . . . . . #
# . . . . . . . . . . #
# # # # # # # # # # # #
