# # # # # # # # # # # #
# . . # x # . . . . # #
# # . . . . . # . . . #
# # . . . . . # . . . #
# . . . . # # # # . . #
# . # . . . . # # # . #
# . # x # . . . . # # #
# # x . # . # # . . . #
# . . . # . . . . . # #
# # # . # x . # . # . #
# # # # . # # # . . . #
# # # # # # # # # # # #
