# # # # # # # # # # # #
# . . x . . . # . . . #
# . . . . # . . . . # #
# . # . . . . . . . . #
# x . . . . . . . . . #
# . # x . . # # # . . #
# . . . # . . . . # . #
# # . . . . # . . . . #
# # . . . # . . . . # #
# # . . . . # . . . # #
# . . # . . . . . . . #
# # # # # # # # # # # #
