# # # # # # # # # # # #
# . . . . . . . . . x #
# . . . # # # . . # . #
# # . . . . # . . . . #
# . . . . . . . . . # #
# . # . # . . . . . . #
# . x . # # . . . . . #
# . . # . . . # . . . #
# # . . . . . # . . . #
# . . . # . # # . # . #
# . . . . . . . . . . #
# # # # # # # # # # # #
