# # # # # # # # # # # #
# . . . # # . # . . . #
# . # . # . . # . # . #
# # . . . . . . # . # #
# . . # . . . . . . . #
# . . . . . . . . . . #
# . # . . . x # # . . #
# . . . # . # . . # # #
# . . . # x . . # # # #
# . . . . . . # # . . #
# . . # x # . . . . . #
# # # # # # # # # # # #
