# # # # # # # # # # # #
# . # . . . # . # . . #
# . # # # . . . . x . #
# . . . . . . . . . . #
# x . # . # . . # # . #
# . . . . # . . . . . #
# . # . . . # . . . . #
# . . # . # . . . . . #
# . . . # . . . # . # #
# . # . . . . . . # # #
# . . . # # # . . . . #
# # # # # # # # # # # #
