# # # # # # # # # # # #
# . . . . . . . . # . #
# . . . . . . . x . . #
# . . . . # . # . . . #
# . . # . . . . # . # #
# . . . . . . . . # . #
# . . . . # . . . . . #
# . . . . . . . . . . #
# . . x . . . . . . . #
# . . . . . # . . . . #
# . . . . . . . . . . #
# # # # # # # # # # # #
