# # # # # # # # # # # #
# . . . # # # . . . # #
# . . . . . . . . . # #
# . . . . . . . # # . #
# . . # # . . . . . # #
# # . . . . # x . . . #
# . . . # . . # . . . #
# . . . # . . # . . . #
# # . . . . . . . . . #
# x . . . # . # . . . #
# . . . . # . # # . . #
# # # # # # # # # # # #
