# # # # # # # # # # # #
# . # . . . . . x . . #
# . . . . . . . . # . #
# . # . . # . . . . . #
# . . . # . . # . . . #
# . # . . . . # . . . #
# . . x . . . . . . . #
# # . . . # . . . . . #
# # . # . . . . . # . #
# . . # . . . . . . . #
# . . . . . . . . . . #
# # # # # # # # # # # #
