# # # # # # # # # # # #
# . . . . . . . . # . #
# # . # . # . . . # # #
# . . . . . . . . # . #
# . # . . . . . # . . #
# # # # . . . # # . . #
# . . . . . . # . . # #
# . . . . . x . . . # #
# . . # # . . . . . . #
# . . . # . . x # . . #
# # . . . # . . . # . #
# # # # # # # # # # # #
