# # # # # # # # # # # #
# . . . . . . . . . . #
# # . . # . . . . . . #
# . # . . . # . . . . #
# . . . . # . . . # . #
# . . # . . . . . . . #
# . . . . . . . . . . #
# . . . . . . . . . . #
# . . . x . . . # # . #
# . . . . . . . # . . #
# . . . . . x . . . . #
# # # # # # # # # # # #
