# # # # # # # # # # # #
# . # . . . . # . # . #
# . . # . . . . # # . #
# # . . . . . . # . # #
# x . . # . . . # . . #
# x . # # . . . . # . #
# # . # # . . # . . . #
# # # . . # . # x . . #
# . . # . . x # # . . #
# . . . . . . . # . . #
# . # . # . # . . # . #
# # # # # # # # # # # #
