# # # # # # # # # # # #
# . . . . . . x # . . #
# . . . . . . . . . . #
# . . . . # . . . . . #
# . . # . . . . # . . #
# # . . . . . . . . # #
# . # # . . x . . . . #
# . . . . . . . . . . #
# . . # . . . . . . . #
# # . . . . . . . . . #
# # . . . . . # . . . #
# # # # # # # # # # # #
