# # # # # # # # # # # #
# . . . . . . . . . # #
# . x . . . . . # . x #
# # # . # # . . . . . #
# x . # . . # . . . # #
# . . . . . # # . . . #
# . . . . . . . . . . #
# . . . . # . . . . . #
# . . . . # . . . . . #
# # . . . . . . # # # #
# . . # . . . . . . . #
# # # # # # # # # # # #
