# # # # # # # # # # # #
# . . # # . . . . . . #
# x . . . . . . . . . #
# . . . . . . . . . # #
# . # # . . # x . . . #
# . # . # . . . . . . #
# . . . # . . . . . . #
# # . . # . . . . . . #
# . # . . # . . . . . #
# . . . # . . . . . . #
# . . . . . . # . . . #
# # # # # # # # # # # #
