# # # # # # # # # # # #
# . . . . . # . . . . #
# . . . . . . . . . # #
# # . . # . . . . . # #
# . . . . . . . . # . #
# . . . . # . . . . . #
# . . . . . . . # . . #
# . . . . . # . . . . #
# . . # # . . . . . # #
# . x . . . . . # . . #
# . . . . x . # . . . #
# # # # # # # # # # # #
