# # # # # # # # # # # #
# . # # . . . # . . . #
# . . # # . # # . . . #
# . x . . # . x # # . #
# . . # . x . . . . . #
# . # # . . . # . # . #
# . . # # . . . # . . #
# . . . . # . . . . # #
# # # . . # # . # . . #
# # x . . . . . . . . #
# # . . . . . # . . . #
# # # # # # # # # # # #
