# # # # # # # # # # # #
# . . # . . . . . . . #
# # . . . . . . . . . #
# . . . . . . # # . . #
# . . # . . . . . . . #
# . . # . . . . . . . #
# . . x . . . . . . . #
# # x . . . . . . . . #
# . # . . . . # . . . #
# x . . # . . . . . . #
# . . . . . . # . . . #
# # # # # # # # # # # #
