# # # # # # # # # # # #
# . . . # # . . # # . #
# # . # . # x . # # . #
# # . . . . . # . . . #
# . . # . . . . . . . #
# . . . # . # . . . # #
# # . . . # # # . # . #
# # # . . . . . . . . #
# # # . . # x # . . . #
# . . # # . . # . # . #
# . . . . . . # # . . #
# # # # # # # # # # # #
