# # # # # # # # # # # #
# . . . . . # . . . . #
# . . # . # . . . # # #
# # # . . . # . . . . #
# # . . . . . # . . . #
# . . . . . # . . . . #
# # # . . # . x # # # #
# . . . . . . # # . . #
# . # . . . . . # # x #
# # . # # # . . . . . #
# . . . . . . # . # . #
# # # # # # # # # # # #
