# # # # # # # # # # # #
# . . . x . . . . . . #
# . . . . . . . . . . #
# x # . # . # . . . . #
# . . # . # . . # . . #
# . . . . . . . x . . #
# . . . . . . # # . # #
# . . . . . . . . . x #
# . . . . . . . . . . #
# . . . . . . . . . # #
# . . . . . . . . . . #
# # # # # # # # # # # #
