# # # # # # # # # # # #
# . . . . . . . . . . #
# . . . . x . # # . . #
# . . . . # . . . . . #
# # . # . . . . . . . #
# . . . . . . . # . . #
# x . # . # . . . # . #
# . # . . . . . # . # #
# # x . . . . # . # . #
# # . . . . . . . . . #
# . . . . . . . . # . #
# # # # # # # # # # # #
