# # # # # # # # # # # #
# . # . . . . . . # . #
# . # # . . . x . . . #
# . . . . x . . . . . #
# . . . . . . # . . . #
# x . . . . . . . # . #
# . . . . . . . # . . #
# . # . . . . . . . . #
# . . . # # . . . # . #
# . . . . . . # . . # #
# x . . . . . # . . . #
# # # # # # # # # # # #
