# # # # # # # # # # # #
# . # . . . . . . . . #
# . # . . # . . . . x #
# . . # # . . . . . . #
# . . . . . . . # . . #
# . . . # . . . . # # #
# . . . . . . . . . . #
# # . . . . . . . . . #
# # . . . . . # . . . #
# . # # . # . . x . . #
# . . . # . . . # . . #
# # # # # # # # # # # #
