# # # # # # # # # # # #
# . # # # . . # . . . #
# . . . . . # . . # x #
# # . . . . # . # . x #
# . . # # . . . # . . #
# . # # . . . . . . # #
# # # # . . . . # # # #
# . . . x . . . . # # #
# . . . # . # x # . # #
# . # # # . . . . . . #
# . . . # . . . . . . #
# # # # # # # # # # # #
