# # # # # # # # # # # #
# . # # . . . . # x . #
# . . # # . x . # . # #
# . . . # # . # . # . #
# # . . . . . . # . . #
# # x # . . . . . . x #
# . . . . . # . . . # #
# . . . . . # . # . # #
# . . . # # . . . . . #
# # . . . . . . . . . #
# . . . . . . . . # . #
# # # # # # # # # # # #
