# # # # # # # # # # # #
# . . # . . # . # . . #
# . . . . . . . . . . #
# . . # . . . . . . # #
# . . . . . . . # . . #
# . . . . . . # . # . #
# . . . . x . . . . # #
# . . # . . . # . . . #
# # . . . . . . . . . #
# . # . # x . # . . . #
# . . . . x . . # . . #
# # # # # # # # # # # #
