# # # # # # # # # # # #
# . . . . . . . # # . #
# . . . . . . . . # # #
# # . . . . . . . . . #
# # . . . # . # . . . #
# . . . # . . . . . . #
# . # . # . . . . . . #
# . . . . . . . . # . #
# . . # x . # . . . . #
# # . . . . # . . . . #
# . . . . . # # x # . #
# # # # # # # # # # # #
