# # # # # # # # # # # #
# . . . . . . # . # # #
# . . . . # . x . . . #
# # . . # . x # . # . #
# . # . . # # . . . # #
# # . . # . # # . # . #
# . . . . # . . . . . #
# . . . . . # . . # # #
# . . . # # . . # . . #
# . . . . . . . . . . #
# # . . . # . . . . . #
# # # # # # # # # # # #
