# # # # # # # # # # # #
# . . . . . . # . . . #
# . . . . x . # # . # #
# # # # . . # . # . . #
# # . . # . . # . # . #
# # . # . . # . . . . #
# # # # . . # . . . # #
# . # # # . . . . . . #
# . # . . x . . . # # #
# . # . . . . . . . . #
# . # . . . # # # . . #
# # # # # # # # # # # #
