# # # # # # # # # # # #
# . x . . . . . . . . #
# . . . . # . . . . . #
# . . . . # . . . . # #
# . . . . . . . # . . #
# . . . # . . . # # . #
# . . . . . . . # . # #
# . . . . # . . . . . #
# . . . . . . . . . # #
# . . x . . . . . . . #
# x # # . . . . . . . #
# # # # # # # # # # # #
