# # # # # # # # # # # #
# . . . # . . # # . . #
# # # . . # # . . . . #
# . # # . . . . # . # #
# # . . . # . . # . . #
# . . . . . . . . . . #
# . . . . # . . . . . #
# . . . . # . # . # . #
# . x . x . . . . . . #
# . . . . . x . . . . #
# x . . . # . . # . . #
# # # # # # # # # # # #
