# # # # # # # # # # # #
# . . . . # # . . # # #
# . . . . . . . # . # #
# . . . # . . . . # . #
# . . # . . . # . . # #
# . . # . # . . . . . #
# # . . . . . . . . . #
# . . . . . # . . x . #
# . . . # . . . . . . #
# . . . . . . . . . . #
# . . # # . . . # x . #
# # # # # # # # # # # #
