# # # # # # # # # # # #
# . . . # . . . . . . #
# . . . # . . # . . . #
# . . . . # . # # . # #
# # . . . # . # # . . #
# . . . . . . # . . . #
# . . # # . . . . . . #
# . . . . . . . . . . #
# . . # . . . . . . x #
# . . . . # . . # . x #
# # . . . . . . # . . #
# # # # # # # # # # # #
