# # # # # # # # # # # #
# . . . # . . # . . . #
# # . . . . # # . . . #
# x . . # . # . . . . #
# . . . . . . . . # . #
# . . # . . . # # . x #
# # . . # . . . . . . #
# . . . . . # # . # . #
# # . . # . . . . . # #
# . x # . . . . . # . #
# . . . . # . . . . . #
# # # # # # # # # # # #
