# # # # # # # # # # # #
# . . . . . . . . . . #
# . . # . . . . . # . #
# . . # . . . # . . # #
# . . . . # . . . . . #
# . . . . . . . x . . #
# # . . . . . . . . . #
# . . . . . . . . . . #
# x . # . . . . # . . #
# . . # . . . . # . . #
# . # . . # . . . . . #
# # # # # # # # # # # #
