# # # # # # # # # # # #
# . . # . . . . . . . #
# # . . . . . . # . . #
# . # . . . . . . . x #
# # # . . . . . . . . #
# . . . # # . . . . . #
# . # . . . . . . . . #
# . . . . . . . # . . #
# . # . . # . . x . # #
# # . . # . . . . . . #
# . . . # x . . . # . #
# # # # # # # # # # # #
