# # # # # # # # # # # #
# . . . # . . . . . . #
# . # . . . . . . # # #
# # . . . . . . . . . #
# . . . . . . . # # . #
# . . . x . . . . . . #
# . . . . . # . x . # #
# . . . . . # . . . # #
# # . . # # . . . . . #
# . x . x . . . . . . #
# . . . . . . . # . . #
# # # # # # # # # # # #
