# # # # # # # # # # # #
# . . . . . x . . x . #
# . . . # # # . . # . #
# . x . # . . # # . . #
# . . # . . . . # . . #
# . # # . . . . . . . #
# . . . . x . . . # . #
# # . . . . . # . . . #
# . . . # . . . . . . #
# # # . # . . . . . # #
# # # . . . . . . . . #
# # # # # # # # # # # #
