# # # # # # # # # # # #
# . . . . . . . . # . #
# . . # . . . . # . . #
# # . . . . . # . # . #
# . . . x . . . . . . #
# . . . . x . . . . . #
# . . . . # . . # . . #
# . . . . . . . . . . #
# . . . . . . . # . . #
# . . . . # . . . . . #
# . . . . # . . . . . #
# # # # # # # # # # # #
