# # # # # # # # # # # #
# . . # # # # # # . . #
# . . # # # # . . . x #
# # . . . . # . # . . #
# # . # . . . . # # . #
# . . . . # . . . . . #
# # . . . . . . # # # #
# # x # . . . # . . # #
# . . # . x . . . . # #
# . # . # # . . # . # #
# . . # . . . . # . . #
# # # # # # # # # # # #
