# # # # # # # # # # # #
# . . . . # . . # . . #
# # . # . . . . . # . #
# # . # . # . . # . . #
# # . . # . . # . . . #
# . # . x # . . . . . #
# # # . # . # # . # . #
# . . . . . # . . . . #
# . . # . . . . . . . #
# . . . . # . # # . x #
# # . . . # . # . . . #
# # # # # # # # # # # #
