# # # # # # # # # # # #
# . . # . # x x . . # #
# . . # # . . . . . . #
# . . . . . . . # . . #
# . . . . . . . . . . #
# . . . . # . . . . . #
# . . # . . . . . . . #
# . x . . . . . . . # #
# . . . x . . . . . . #
# . . . . . . . # . . #
# . . . . . . . . . . #
# # # # # # # # # # # #
