# # # # # # # # # # # #
# . # . . . . . . . . #
# . . . . . . . # . . #
# . . . . . . . . . . #
# . . . . . . . . . # #
# . . . . . . . . . # #
# x . . . . . . x . . #
# . . . . . . . # . . #
# # . x . . . . # . . #
# . . . . . # . . . # #
# . . . . # . . . . . #
# # # # # # # # # # # #
