# # # # # # # # # # # #
# . . . . . . . . . . #
# # . . . # . . . . . #
# # . . . . . . . . . #
# . x . # # . . . . . #
# # . . . . . . . x # #
# . . . . # . . # . . #
# # . # # . . . . . # #
# . . . . . . . # . . #
# . . . . # . . . . . #
# . # . . . . . . . . #
# # # # # # # # # # # #
