# # # # # # # # # # # #
# . . . . . . . . . # #
# # . . . . . . . . # #
# . . . # . . . . # . #
# . # . . . . . . . . #
# . . . . . . . . . # #
# . . . # . . . # . . #
# . . . . . # . . . . #
# . . . . . . . . . . #
# . # . . . . . . . x #
# . . . . . x . . . . #
# # # # # # # # # # # #
