# # # # # # # # # # # #
# . . . . . . . . . . #
# . . . # # . . . # . #
# . . # . . . . . # . #
# . . . # . . . . # . #
# . . . . . . . . . . #
# . . . . . . . . . . #
# . . . . . . . . . . #
# . . . . x . . # # # #
# . x . . . . . . . . #
# . . . # . . . . x . #
# # # # # # # # # # # #
