# # # # # # # # # # # #
# . . . # # x # # . . #
# . # . # x . . x # . #
# . . # # # . . # # . #
# # . . . # # # . . . #
# # # # . # . # # # . #
# . # . . . # # . # . #
# . . # # . . . # # . #
# # # # # # # . . . . #
# . . . . . . . . # . #
# . . . . . . . # # . #
# # # # # # # # # # # #
