# # # # # # # # # # # #
# . # . . . . . . . x #
# . . # . . . . # # . #
# . . . . . . . . . . #
# . . # . # . . . . . #
# . . . # . . . . . # #
# . . . . . . . . . . #
# # # . . x # # . . # #
# . . x . . . . . . . #
# . . . . . . # # . . #
# # . x . # # . . . . #
# # # # # # # # # # # #
