# # # # # # # # # # # #
# . . . . . # . . # # #
# . . . . . . . # x # #
# # . . # . # . . . # #
# x . . . . . . . # . #
# . x . # . . . . . . #
# . . . . . . . # . . #
# . # . # # . . . . . #
# . # . . . . . # . . #
# . # . . . # . # . . #
# . . . # . . . . # . #
# # # # # # # # # # # #
