# # # # # # # # # # # #
# . . . . . # # . # . #
# . . . # . . . . . . #
# . # . . . . . . . # #
# . . . . # # . x . # #
# # . # # . # . . x # #
# . . . . . . . . # # #
# . . . . . . . # . . #
# . . # # # . # . . . #
# # . . . . . . . . . #
# . . # . . . . . # . #
# # # # # # # # # # # #
