# # # # # # # # # # # #
# . . . . # . . . . . #
# . x . . # . # . . . #
# . . . . # . # . . . #
# . . . # # . . . . . #
# . x . . . . . . . . #
# . . . . # . . # . . #
# . . . . # . . # . . #
# . . . . . . . . . x #
# . . . . . . # . # # #
# # # . x # # . . . . #
# # # # # # # # # # # #
