# # # # # # # # # # # #
# . # # . x . . . . # #
# . . . # . # . # . # #
# # . # # # x . . . . #
# . . . . . . . . . . #
# . # . # . . . . . # #
# . . . # . . . . # . #
# . . . # . . x . . . #
# . # . . . . . . . . #
# . # . . . . . . . . #
# . . . . . . # . . . #
# # # # # # # # # # # #
