# # # # # # # # # # # #
# . . # . # . . . . . #
# . . # . . . # . . x #
# . # . . . . . . . . #
# . # . . . . . . . . #
# . . . . # . . . . . #
# . # # . . . . . . . #
# . . . x . . . . # . #
# . . . . . . . . . . #
# . . . . . . . . . . #
# . . . x . . . # . . #
# # # # # # # # # # # #
