# # # # # # # # # # # #
# . # # . . . . . . . #
# . . . # . . . . . . #
# . # # . # # . # . . #
# . . . # . . . . . . #
# . . . . # . . . x . #
# . . . . . . . . . . #
# . . . # . . . . . . #
# . . . . x . . . . . #
# # . . . . . . . . . #
# # . . . . . . . . . #
# # # # # # # # # # # #
