# # # # # # # # # # # #
# . x . . . . . . . # #
# . . . . # . . . . . #
# . . # . . . # . # . #
# . . . . . # . # . . #
# . . . . . . . . . . #
# . . . x . . . . . . #
# . . . # # . . . . . #
# . . . # . . . . x # #
# . . . . . . . . . . #
# . # . . x . . . . . #
# # # # # # # # # # # #
