# # # # # # # # # # # #
# . . . . . . . . . . #
# . . . # . # . . . . #
# . . . . . . . . . . #
# # # . # # . . . # . #
# . x # . # . # . # # #
# . . . . . . . # . . #
# # # . . . . . . . . #
# . . # . . x . . . . #
# # # . # # # . . . . #
# . # x . # . . . # . #
# # # # # # # # # # # #
