# # # # # # # # # # # #
# . . . . # . # # # . #
# # # . . # . . # . . #
# . . # . . . . . x # #
# . # . . . x . . . . #
# # # # # # # . . . . #
# . . . . # . . # # # #
# . . . . . . . . . # #
# # . . # . . . . . . #
# . . . . x . x # # . #
# . # . . . # . . # . #
# # # # # # # # # # # #
