# # # # # # # # # # # #
# . . # . . . . . . . #
# . . . # # . . . . . #
# . . . x . # # # . # #
# . . # . . . # # . . #
# # . . . # . . # # . #
# . . . . # . . # . . #
# . . . . . . . x . . #
# . . . # . . . # . . #
# . # . . # . # . . . #
# . . # . . . . . # . #
# # # # # # # # # # # #
