# # # # # # # # # # # #
# . x . . x . . . . # #
# . . . . . . . . . # #
# . . . . # . . . . . #
# . . . . . . . . # . #
# . . . . . . . . . . #
# . . . . . x . . . . #
# . . . . . . . . . # #
# . . . . . # # # . . #
# . . . . . . . # . . #
# # x # . # . # . . . #
# # # # # # # # # # # #
