# # # # # # # # # # # #
# . . . . . . . . # . #
# . . . . x . . . . . #
# # . . . . # . # . . #
# . . . . . x # # . . #
# . . . . # . . x . . #
# . . # . . . . . . . #
# . . x . . . . # . . #
# . . . . . . . . . . #
# . . . . . . . . . . #
# . . . . . . . . . . #
# # # # # # # # # # # #
