# # # # # # # # # # # #
# . # . . # . . x . # #
# . . # # . . # . # # #
# . . . . # . . . # . #
# # . . . . . . . # . #
# . # . . . . . . . . #
# . . . # . . . . . . #
# . . . # . # . . . . #
# . . . . . . # # . . #
# # # . . . . . # . x #
# . . . . . . # . . . #
# # # # # # # # # # # #
