# # # # # # # # # # # #
# . . . . # . # . # . #
# . . . . . . . . . . #
# . . # . . . . . # . #
# . . . . . . . . . . #
# # . . # . . # . # . #
# . . . # # . . . . # #
# . . . . . x . . . . #
# . . . . . # . . . . #
# # # . . . . . . # . #
# . x . . . . . . . . #
# # # # # # # # # # # #
