# # # # # # # # # # # #
# . . x # # . . . . . #
# # . . # x . # . . . #
# . # . # . . . . . # #
# # # . . . . # . . . #
# . # . # . . . # # . #
# . . . . # . . . . . #
# . . . . . . # . # . #
# . . # . . . . x . . #
# . # # . . . . . . . #
# # . # . . . . . x . #
# # # # # # # # # # # #
