# # # # # # # # # # # #
# . . x . # . . . . # #
# # . x . # . . # . # #
# # . . . . . . # . . #
# . . . . . # . . # . #
# . . . . . . . . . . #
# . . . . . . # . . . #
# # # x . . . . # # x #
# . # # . # # . # . . #
# . . . . . . . . . . #
# . . . # # # . . . . #
# # # # # # # # # # # #
