# # # # # # # # # # # #
# . . . . # . . . . . #
# . . # . x . # . . # #
# . # . . # # . x # . #
# . . . . . . # . . . #
# . . # . . . # . # . #
# # # x . . . # . . . #
# # # # . . . . . # . #
# . . . . # . # . # . #
# # . # . . . # . # . #
# # . # . # # # . . . #
# # # # # # # # # # # #
