# # # # # # # # # # # #
# . . . . . . . # . . #
# . . # . # # . # x # #
# . . x . . # . . . . #
# . # . # . # . . . # #
# # # . # . . . # . . #
# . # . . # . . . # . #
# . . . # . . . . # # #
# x . . # . . # . . . #
# . # . # . . . . # . #
# . # # . # . # . . . #
# # # # # # # # # # # #
