# # # # # # # # # # # #
# . # . . . . . . . x #
# . . . . . . . # . . #
# # # . # . . . . . . #
# . . . . . # # . . # #
# # . # . . . . . . . #
# . . . . # . . # # . #
# # # . # . . . . . . #
# x # . . . . . x . . #
# . . . . . . . . . . #
# # . . . # . . . . . #
# # # # # # # # # # # #
