# # # # # # # # # # # #
# . . . # . . . . . . #
# . . . . . # . . . . #
# . . # # . . # . . . #
# # . # . . . . . . . #
# . . . . # . # . . # #
# . . . . . # . x . . #
# . . . . # . . . . . #
# . . . x . . . # . . #
# . . . # # . . . . . #
# # . . . # . # # . . #
# # # # # # # # # # # #
