# # # # # # # # # # # #
# . . . . . . . . . . #
# . # . . . . . . . . #
# . . . . . . # . # # #
# # . . . . . . . . . #
# . # . . . . . x . . #
# . . . . . . x . . # #
# . . . . # . . # # . #
# . . . # x . . . . . #
# # . . . x . . . . . #
# . . . . . . . . . . #
# # # # # # # # # # # #
