# # # # # # # # # # # #
# . . . # . # # x # . #
# . . # . . # . . . . #
# . # # . # x . . . . #
# . # . . . . . # # # #
# . . . . . # # # . . #
# . . # # . # . # . # #
# . . . # . . # . # . #
# . . . . . . . # # . #
# . . # . . # . . . . #
# # . # . . . # # . . #
# # # # # # # # # # # #
