# # # # # # # # # # # #
# . . x . . # . . . . #
# # . . . . . . # . . #
# . . . # . . . # . . #
# . . . # . . . . . . #
# . . . . # . # # . . #
# . . # . . . x # . x #
# # . . . . . . . . . #
# . . . . # . . . . . #
# . . . . . . . # . . #
# . . . . . . # . x . #
# # # # # # # # # # # #
