# # # # # # # # # # # #
# . . . # # . # . . # #
# . . . . . . # # . # #
# . . # . . # . # . . #
# # # # . # . . # . . #
# . . # . # . . . . # #
# . . . . . . . . . . #
# . . x . . . . # . . #
# . . # . . . . . . # #
# . . . . . # x . . # #
# . # # . . . . . . . #
# # # # # # # # # # # #
