# # # # # # # # # # # #
# . . . # . # . . x . #
# . x . . . . . . . . #
# . . . . . . . . . x #
# # # . # . . . # . . #
# . . . # . . . . # . #
# . . . . . . . # . # #
# . . # . . # . . . . #
# . . # . # . . # . . #
# # . . . . . . . . # #
# . . # . . . . . . . #
# # # # # # # # # # # #
